readme			Q.この[kanword.tsv]は何ですか。 A.漢直エディタ「kanedit」用の汎用辞書です。# Copyright (c) 2016 ooblog # License: MIT # https://github.com/ooblog/LTsv10kanedit/blob/master/LICENSE
かんちょく		漢直
ハリツケ			貼付
ひらがな			平仮名
カタカナ			片仮名
平仮名	あいうえおかきくけこさしすせそたちつてとなにぬねのはひふへほまみむめもやゆよらりるれろわをん
片仮名	アイウエオカキクケコサシスセソタチツテトナニヌネノハヒフヘホマミムメモヤユヨラリルレロワヲン
イロハ			いろはにほへとちりぬるをわかよたれそつねならむうゐのおくやまけふこえてあさきゆめみしゑひもせす
イロハヒラガナ		いろはにほへとちりぬるをわかよたれそつねならむうゐのおくやまけふこえてあさきゆめみしゑひもせす
イロハカタカナ		イロハニホヘトチリヌルヲワカヨタレソツネナラムウヰノオクヤマケフコエテアサキユメミシヱヒモセス
セイオン			清音
ダクオン			濁音
ハンダクオン		半濁音
ゼンカク			全角
ハンカク			半角
オオモジ			大文字
コモジ			小文字
アルファベット		ＡＢＣＤＥＦＧＨＩＪＫＬＭＮＯＰＱＲＳＴＵＶＷＸＹＺ
アルファベットコモジ	ａｂｃｄｅｆｇｈｉｊｋｌｍｎｏｐｑｒｓｔｕｖｗｘｙｚ
アルファベットオオモジ	ＡＢＣＤＥＦＧＨＩＪＫＬＭＮＯＰＱＲＳＴＵＶＷＸＹＺ
ギリシア			ΑΒΓΔΕΖΗΘΙΚΛΜΝΞΟΠΡΣΤΥΦΧΨΩ
ギリシアコモジ		αβγδεζηθικλμνξοπρστυφχψω
ギリシアオオモジ		ΑΒΓΔΕΖΗΘΙΚΛΜΝΞΟΠΡΣΤΥΦΧΨΩ
キリル			АБВГДЕЁЖЗИЙКЛМНОПРСТУФХЦЧШЩЪЫЬЭЮЯ
キリルコモジ		абвгдеёжзийклмнопрстуфхцчшщъыьэюя
キリルオオモジ		АБВГДЕЁЖЗИЙКЛМНОПРСТУФХЦЧШЩЪЫЬЭЮЯ
base64		ABCDEFGHIJKLMNOPQRSTUVWXYZabcdefghijklmnopqrstuvwxyz0123456789+/=
ベースロクヨン		ABCDEFGHIJKLMNOPQRSTUVWXYZabcdefghijklmnopqrstuvwxyz0123456789+/=
カンタイジ		簡体字
ハンタイジ		繁体字
チュノム		字喃
テンジ			点字
ぎなたよみ		ぎなた読み
シロナガスクジラ		白長須鯨
シロナ			白菜
ガス			瓦斯
クジラ			鯨
イルカ			海豚
ムツヨコハマ		陸奥横浜
ムツ			陸奥
ヨコハマ			横浜
おーぶろぐ		ooblog
クドウフレア		九堂フレア
コウソクミユ		光束ミユ
アカシレクィド		明石レクィド
モモイシルキ		桃井シルキ
ハクバクレイ		白馬クレイ
フユキアケミ		深雪アケミ
あいせき			相席
ブクリョウ		茯苓
フクシ			福祉
フキノトウ		蕗薹
タタラ			踏鞴
ブッダ			仏陀
フカン			俯瞰
フーテン			瘋癲
フウテン			瘋癲
ブドウ			葡萄
タンカイ			坦懐
フンガイ			憤慨
フヨウ			芙蓉
フウフ			夫婦
フクシュウ		復讐
ガンシュウ		含羞
ハニカム			含羞む
フビン			不憫
アイマイ			曖昧
チュウチョ		躊躇
アタゴ			愛宕
コシアン			漉餡
ショウケイ		憧憬
ドウケイ			憧憬
ロカイ			蘆薈
ガラン			伽藍
アイサツ			挨拶
カイザン			改竄
シュウシュウ		蒐集
コウヨウ			昂揚
モクヨク			沐浴
クマノミ			隈魚
ネギ			禰宜
ロパ			驢馬
デンデンムシ		蝸牛
カタツムリ		蝸牛
ゴポウ			牛蒡
ウドン			饂飩
モズク			海蘊
ウショク			齲蝕
ホウトウ			餺飥
エイキ			盈虧
エンオウ			冤枉
キョウエン		饗宴
エリモ			襟裳
エリモミサキ		襟裳岬
ロウア			聾唖
ハシカ			麻疹
ガマ			蝦蟇
シンセキ			親戚
ダンジョ			男女
セイテツ			甥姪
カンラン			橄欖
キョウガク		驚愕
インコ			鸚哥
オウム			鸚鵡
オシドリ			鴛鴦
オトメ			乙女
シユウ			雌雄
ロウカイ			老獪
オウトツ			凹凸
スイジュウ		錘重
ジュウチン		重鎮
シュクハク		宿泊
ダシ			山車
アンイ			安易
マツリ			茉莉
ヤユ			揶揄
カネジャク		矩尺
キュウシャ		厩舎
シャガ			釈迦
ヘキエキ			辟易
ハクシャク		伯爵
ジュホウ			褒綬
ユウガ			優雅
ユウセツ			融雪
シュサイ			主宰
ジュウタン		絨緞
ジュンレイ		醇醴
ジュウリン		蹂躙
シュウカク		収穫
ヨレキ			余瀝
カンヨウ			涵養
ゲンヨウ			衒耀
ヨウカン			羊羹
ドクショ			読書
ヨウチョウ		窈窕
ウンジョウ		醞醸
アア			嗚呼
ショウユ			醤油
ジョウチョ		情緒
ジョウキョウ		状況
ジショ			辞書
ショクゲキ		食戟
カグヤ			赫夜
ワガママ			我儘/我侭
センベツ			餞別
ワイセツ			猥褻
フットウ			沸騰
シュウショク		就職
ショウワ			昭和
バショウ			芭蕉
ケショウ			化粧
ホウシュウ		報酬
ホウレン			菠薐
ボサツ			菩薩
ホフク			匍匐
ホウライ			蓬莱
ホウポク			放牧
スイセイ			彗星
ボウフラ			孑孒
ホウオウ			鳳凰
ボウトク			冒涜
ホソク			捕捉
サイボウ			細胞
ボウコウ			膀胱
ホウコウ			砲熕
コットウ			骨董
ホウラク			炮烙
ボクトツ			朴訥
ボウセキ			紡績
ホウフツ			彷彿
ホウコウ			彷徨
サマヨウ			彷徨う
ホンロウ			翻弄
ヘイタン			兵站
ベンケイ			弁慶
ダンガイ			弾劾
チョリュウ		瀦溜
ヒョウタン		瓢箪
タンス			箪笥
タンス			田圃
ベンチ			胼胝
チャブダイ		卓袱台
ダンラン			団欒
テイデン			停電
ショクタク		嘱託
コウカン			槓杆
タンテイ			探偵
セッケン			石鹸
イイン			医院
イカン			遺憾
イカク			威嚇
サバグ			砂漠
スイコウ			推敲
スイリン			垂綸
エナガ			韈雀
コンスイ			昏睡
スワ			諏訪
タンコウ			炭坑
ライセキ			賚錫
フナズシ			鮒鮨
カシ			瑕疵
カセン			河川
カレー			咖喱
クンユウ			薫蕕
フウボウ			風貌
カカク			価格
カヤブキ			萱葺
カイボウ			解剖
スルガ			敦賀
ゲンカン			玄関
ミナス			見做す
ミナシ			見做し
ガビョウ			画鋲
カゴ			駕籠
カンガイ			灌漑
カンパイ			乾杯
カツシカ			葛飾
カンキツ			柑橘
ナオスケ			直弼
ナオカツ			尚且つ
カンボジア		柬埔寨
カンシャク		癇癪
ドウカツ			恫喝
カッサイ			喝采
カリソメ			苟且/仮初め
コウショ			苟且
コウゲイ			虹霓
タイトウ			螮蝀
タイトウセン		螮蝀泉
ホニュウ			哺乳
ラッキョウ		辣韮
ハツカ			廿日
ニンキョウ		任侠
テニオハ			弖爾乎波
ニンシン			妊娠
キセン			貴賎
チョウト			刁斗
ヨウドウ			窰洞
ドウクツ			洞窟
トウタ			淘汰
ラクダ			駱駝
アルパカ			羊駱駝
ライコウ			雷汞
マンダラ			曼荼羅
ラテン			羅甸
カクラン			攪乱
カクハン			攪拌
ハンラン			氾濫
ランショウ		濫觴
シボウ			脂肪
チンシツ			疢疾
シンタイ			身体
フシクレ			節榑
タイセイ			頽勢
ヒッパク			逼迫
ガイセン			凱旋
センセイ			先制
セキレイ			鶺鴒
ゼセイ			是正
セイフク			征服
ゼンザイ			善哉
セダイ			世代
コツゼン			忽然
キョウサク		狭窄
カシャク			呵責
セキツイ			脊椎
ウチュウ			宇宙
ドウチャク		撞着
チョチク			貯蓄
シャガ			著莪
テイネイ			丁寧
サイジャク		纔着
チミモウリョウ		魑魅魍魎
エントウ			遠投
メイレイ			螟蛉
ホウジョウ		豊穣
ドジョウ			土壌
コウコツ			恍惚
トンボ			蜻蛉
トッサ			咄嗟
シタザサエ		下支え
シシツ			資質
シシュウ			刺繍
ジロウ			痔瘻
シット			嫉妬
シゴト			仕事
ジケン			事件
シジュン			諮詢
カジツ			果実
ジッセン			実践
カツラギ			葛城
オイラン			花魁
ケイソク			計測
イチレンタクショウ	一蓮托生
レンタク			蓮托
カンキョ			函渠
ボックスカルバート	函渠
ハツモウデ		初詣
ハバタキ			羽搏き
ハバタク			羽搏く
パッテキ			抜擢
バーム			棕櫚
バイバイ			売買
ハッコウ			醗酵
ギヨウ			伎癢
カキョウ			佳境
キュウキョク		究極
メッキ			鍍金
キンケン			金券
モロコシ			蜀黍
ショクショ		蜀黍
セッキ			聶記
キキョウ			桔梗
コウソク			梗塞
キソ			基礎
ギャクサン		逆算
ギセイ			犠牲
キリン			麒麟
セッサ			切磋
ユウヒ			熊羆
ヤカン			薬罐
キョウケン		狂狷
ザンゲ			懺悔
クモ			蜘蛛
メマイ			眩暈
コントン			混沌
コウショウ		交渉
マヒ			痳痺
シンチュウ		真鍮
タカツキ			籩豆
マイコ			舞妓
ワイロ			賄賂
ゴウマン			傲慢
マサツ			摩擦
エンドウ			豌豆
カノウ			嘉納
テイショク		觝触
インコウ			咽喉
ザンシ			残滓
ザンサイ			残滓
ハンチュウ		範疇
オウト			嘔吐
バラ			薔薇
ショクバイ		触媒
ゲッシ			齧歯
チソウ			馳走
ボシ			母趾
ハイリョ			配慮
バッサイ			伐採
バンサン			晩餐
テイシン※鍼		鍉鍼
コウリ			鴻離
リンパ			淋巴
カンリン			翰林
ヤブサカ			吝さか
リンショク		吝嗇
ケチ			吝嗇
リンゴ			林檎
リュウチョウ		流暢
ハンリョ			伴侶
ワガハイ			吾輩
ザンシン※鍼		鑱鍼
ハイカイ			徘徊
ハバツ			派閥
カイリ			乖離
ショウヨウ		逍遥
デイコ			梯梧
デイゴ			梯梧
シレツ			熾烈
レイロウ			玲瓏
レモン			檸檬
ギフ			岐阜
スウキキョウ		枢機卿
キカイ			機械
キョウコウ		僥倖
キンシン			謹慎
キンキ			近畿
キョギョウ		虚業
トグロ			蜷局
アツレキ			軋轢
ケンコウ			健康
ケンズイ			遣隋
ケンズイシ		遣隋使
ケンソン			謙遜
ケンケツ			献血
ケッショウ		血漿
ケイヒン			迎賓
ケンサク			検索
カイケツ			怪傑
カンカンガクガク		侃侃諤諤
ケイレン			痙攣
ケンカ			喧囂
ケンケンゴウゴウ		喧喧囂囂
ゲンコウ			健康
ケサ			袈裟
ケイハン			畦畔
ケイイ			経緯
ケイチツ			啓蟄
ムスメムコ		娘婿
ハチュウ			爬虫
トウカイ			韜晦
ジョウトウ		常套
ツジツマ			辻褄
ヅヅジ			躑躅
タクシ			沢岻
ユウカイ			誘拐
ザクロ			柘榴
サクソウ			錯綜
ソウゾウ			想像
ギオン			祇園
ソゴ			齟齬
ソガイ			疎外
キソン			毀損
ギソウ			艤装
ソツウ			疏通
ソショウ			訴訟
ソウゾク			相続
エンユウ			苑囿
ウッソウ			蔚蒼
ヒゾウ			脾臓
コーヒー			珈琲/咖啡
カフェイン		咖啡涅
ビワ			枇杷/琵琶
スイカ※炎		燧火
ニンジン			人蔘
ヒカク			比較
ビンロウ			檳榔
ケンケンヒキュウ		蹇蹇匪躬
コロアイ			頃合
コンニャク		蒟蒻
ウスイ			碓氷
コショウ			胡椒
コウモリ			蝙蝠
コウカツ			狡猾
カイ			甲斐
コトサラ			殊更
キャヒア			鱣子
キッコウ			拮抗
ゴビュウ			誤謬
ミコシ			御輿
ミミズ			蚯蚓
アメンボ			水黽
スイミャク		水脈
ミソ			味噌
リョクバン		緑礬
ロクバン			緑礬
ミョウバン		明礬
タクマ			琢磨
サガ※姓			嵯峨
ショウナン		湘南
ビシャ			毘沙
ビシャモン		毘沙門
サンラン			燦爛
オウサツ			鏖殺
チュウミツ		稠密
チョウミツ		稠密
サンゴショウ		珊瑚礁
センモウ			譫妄
ソシャク			咀嚼
ソウスイ			総帥
モクトウ			黙祷
モウロウ			朦朧
バンソウコウ		絆創膏
ネンボウ			年俸
キュウソ			窮鼠
コンキョ			根拠
オンサ			音叉
ヒボウ			誹謗
ヒケツ			秘訣
ヒヤク			秘鑰
シュンビン		俊敏
ヒイキ			贔屓
コウゴウ			皇后
コハク			琥珀
コウカツ			宏闊
コウコウ			孝行
ゴウゴ			豪語
ゴィ			語彙
ダイゴ			醍醐
シュンコウ		竣工
ラーメン			拉麺
パン			麺麭
ゴボウセイ		五芒星
メイテイ			酩酊
ヒンボ			牝牡
スイハン			炊飯
シメイ			氏名
オックウ			億劫
メイセキ			明晰
ルリ			瑠璃
ハッコウ			八紘
ヒャッケン		百閒
センシュウ		千穐
ガレキ			瓦礫
カッポウギ		割烹着
モウセン			毛氈
フェルト			毛氈
モウロク			耄碌
ロウバイ			狼狽
ビョウボウ		渺茫
グウキョウ		禺彊
ブランコ			鞦韆
キョウカイ		羌瘣
ユウジョ			宥恕
リウム			𠌃謨
トッカン			吶喊
キセキ※高齢者		耆碩
エフタル			囐噠/挹怛
ヒョウグツワ		鑣轡
アクビ			呿呻
カンガン			顑頷
ライカイ			磊磈
ハツラツ			潑溂
ダンオドシ		緂縅
ショウキョウ		惝怳
ショウコウ		惝怳
ショウスイ		憔悴
ヘイカン			狴犴
オオイタビ		薜荔
ナウル			瑙魯
モウドウ			艨艟
クエン			枸櫞
クエンサン		枸櫞酸
カイコウ			邂逅
ゴキブリ			曱甴/蟑螂/蜚蠊
イツボウ			鷸蚌
インエイ			胤裔
ガイエイ			孩嬰
ロウコク			螻蟈
コオロギ			蟋蟀
キリギリス		螽蟖/蛬
カンバツ			旱魃
トカゲ			蜥蜴
ケイコウ			閨閤
グミ			茱萸/胡頽子
アンコウ			鮟鱇
ヨウハン			鎔笵
ラッパ			喇叭
カリン			榠樝
ヒンシュク		顰蹙
カンタン			邯鄲
ロクロ			轆轤
コウケツ			纐纈
コウケチ			纐纈
カマキリ			螳螂/蟷螂
ヘキレキ			霹靂
ホウテキ			抛擲
インギン			慇懃
セツヨウ			癤癰
チョウソウ		疔瘡
にほん			日本
とどうふけん		都道府県
都道府県		北青岩城秋形島茨栃群埼千東神潟富石井梨野岐静知三滋京阪兵奈和鳥根岡広口徳川媛高福佐長熊分宮鹿沖
ほっかいどう		北海道
オシドマリ		鴛泊
カフカ			香深
アカン			阿寒
アサヒカワ		旭川
アッケシ			厚岸
アバシリ			網走
イケダ			池田
エサ			江差
エリモ			襟裳
オコッペ			興部
オシャマンベ		長万部
オタル			小樽
オビヒロ			帯広
カミカワ			上川
キタミ			北見
ルベシベ			留辺蘂
クシロ			釧路
アカン			阿寒
テシベツ			徹別
パシクル			馬主来
サッポロ			札幌
バラト			茨戸
スナガワ			砂川
トウヤコ			洞爺湖
トマコマイ		苫小牧
ナカサツナイ		中札内
ナヨロ			名寄
ニセコ			二世古
ネムロ			根室
ゴヨウマイ		珸瑶瑁
ノサップ			納沙布
ノボリベツ		登別
トンケシ			富岸
ハコダテ			函館
イシカリ			石狩
ビエイ			美瑛
ハマトンベツ		浜頓別
フラノ			富良野
マシケ			増毛
ムロラン			室蘭
モリ			森
ユウバリ			夕張
ヨイチ			余市
リジリ			利尻
ルモイ			留萌
レブン			礼文
ヒダカ			日高
ケリマイ			鳧舞
セタナ			瀬棚
ムカワ			鵡川
トクシュンベツ		徳舜瞥
ワッカナイ		稚内
ハボマイ			歯舞
シコタン			色丹
クナシリ			国後
エトロフ			択捉
カラフト			樺太
とうほく			東北
あおもり			青森
モヤ			雲谷
スカユ			酸ヶ湯
ウシロヤチ		後萢
オオマ			大間
オソレザン		恐山
クロイシ			黒石
ゴショガワラ		五所川原
トワダ			十和田
サンノヘ			三戸
タゴ			田子
サンノヘ			三戸
トマベチ			苫米地
ゴノヘ			五戸
ロクノヘ			六戸
シチノヘ			七戸
ジンバ			治部袋
ハチノヘ			八戸
ヒロサキ			弘前
ナイジョウシ		撫牛子
ツガル			津軽
アジガサワ		鰺ヶ沢
イカリガセキ		碇ヶ関
ナンブ			南部
ムツ			陸奥
ムツヨコハマ		陸奥横浜
オイラセ			奥入瀬
タッピ			竜飛
タッピサキ		竜飛崎
ハッコウダ		八甲田
ケナシタイ		毛無岱
シモキタ			下北
ヒガシドオリ		東通
シツカリ		尻労
サルガモリ		猿ヶ森
シシパシ			鹿橋
フカウラ			深浦
トドロキ※馬		驫木
いわて			岩手
オオフナト		大船渡
カマイシ			釜石
トオノ			遠野
ハナマキ			花巻
ヒライズミ		平泉
ミヤコ			宮古
もりおか			盛岡
リクゼンタカダ		陸前高田
みやぎ			宮城
イシノマキ		石巻
オナガワ			女川
ケセンヌマ		気仙沼
トドダイ			鰢台
センダイ			仙台
トメ			登米
ナルコ			鳴子
イチノヘ			一戸
ニノヘ			二戸
クノヘ			九戸
ヒガシマツシマ		東松島
ミヤト			宮戸
カシマ			鹿嶌
あきた			秋田
カクノダテ		角館
ヨコテ			横手
ヌカマキザワ		粐蒔沢
やまがた			山形
カスミ			香澄
コガスガイ		小鍄
サカタ※酒		酒田
シンジョウ		新庄
ツルオカ			鶴岡
テンドウ			天童
ヨネザワ			米沢
ニカホ			仁賀保
ショウナイ		庄内
サカタ※砂		砂潟
オガ			男鹿
かたがみ			潟上
トドロキ※廿		廿六木
ふくしま			福島
イワキ			磐城/石城/岩城
グミダイラ		茱莄平
キタカタ			喜多方
コオリヤマ		郡山
トウノヘツリ		塔の岪
アイズ			会津
ミナミアイズ		南会津
ヒノエマタ		檜枝岐
タカシマ			高陦
かんとう			関東
いばらき			茨城
カサマ			笠間
タカハギ			高萩
ツチウラ			土浦
ミト			水戸
ヒタチナカ		常陸那珂
カスミガウラ		霞ヶ浦
ツクバ			筑波
とちぎ			栃木
ウツノミヤ		宇都宮
ナス			那須
ニッコウ			日光
ぐんま			群馬
タカサキ			高崎
ヌマタ			沼田
マエバシ			前橋
ヌデジマ			橳島
ミナカミ			水上
ウスイ			碓氷
さいたま			埼玉
フカヤ			深谷
フジミノ			富士見野
トキガワ			都幾川
ちば			千葉
イチハラ			市原
オオアミ			大網
カツウラ			勝浦
カモガワ			鴨川
キサラヅ			木更津
サワラ			佐原
タテヤマ			館山
チクラ			千倉
チョウシ			銚子
イヌボウサキ		犬吠埼
フッツ			富津
マクハリ			幕張
ワダウラ			和田浦
イスミ			夷隅
とうきょう		東京
チヨダ			千代田
チュウオウ		中央
ミナト			港
シンジュク		新宿
ブンキョウ		文京
ミョウガダニ		茗荷谷
タイトウ			台東
スミダ			墨田
コウトウ			江東
シナガワ			品川
メグロ			目黒
オオタ			大田
セタガヤ			世田谷
シブヤ			渋谷
ナカノ			中野
スギナミ			杉並
トシマ			豊島
キタ			北
アラカワ			荒川
イタバシ			板橋
ネリマ			練馬
アダチ			足立
カツシカ			葛飾
エドガワ			江戸川
アキハバラ		秋葉原
アサクサ			浅草
ウエノ			上野
オオクボ			大久保
オダイバ			お台場
ギンザ			銀座
コウラクエン		後楽園
シブヤ			渋谷
シンジュク		新宿
ニホンバシ		日本橋
イケブクロ		池袋
ハラジュク		原宿
アキルノ			阿伎留野
イズ			伊豆
ハチジョウ		八丈
ミヤケ			三宅
オガサワラ		小笠原
ニシノ			西之
イオウ			硫黄
ベヨネース		波浪巣
ミナミトリ		南鳥
オキノトリ		沖ノ鳥
かながわ			神奈川
オダワラ			小田原
カマクラ			鎌倉
カワサキ			川崎
ハコネ			箱根
ヨコスカ			横須賀
ヨコハマ			横浜
サガミ			相模
ショウナン		湘南
ミウラ			三浦
ズシ			逗子
ちゅうぶ			中部
にいがた			新潟
トドロキ※廿		廿六木
ウオヌマ			魚沼
サド			佐渡
リョウツ			両津
ジョウエツ		上越
ナガオカ			長岡
ムラカミ			村上
ユザワ			湯沢
ヒウ			薭生
とやま			富山
タカオカ			高岡
ヤオ			八尾
となみ			砺波
いしかわ			石川
カナザワ			金沢
コマツ			小松
スズ			珠洲
ワクラ			和倉
カホク			河北
ふくい			福井
オバマ			小浜
スルガ			敦賀
アラワ			芦原
オオイ			大飯
やまなし			山梨
コウフ			甲府
コブチザワ		小淵沢
ナガノ			長野
カルイザワ		軽井沢
キソ			木曾
コマガネ			駒ヶ根
チクマ			千曲
フジヌタ			藤垈
アイヌタ			相垈
オンタ			大垈
グミノ			萸野
ながの			長野
ハクバ			白馬
マツモト			松本
ぎふ			岐阜
グジョウ			郡上
ゲロ			下呂
タカヤマ			高山
トキ			土岐
ナカツガワ		中津川
しずおか			静岡
イシダル			石橸
アタミ			熱海
サクマ			佐久間
シモダ			下田
シュウゼンジ		修善寺
ハママツ		浜松
フジノミヤ		富士宮
マツザキ		松崎
ミシマ			三島
あいち			愛知
アンジョウ		安城
オカザキ		岡崎
グミヅル		茱莄蔓
トコナメ		常滑
トヨタ			豊田
ムナカタ			胷形/胸形
トヨハシ		豊橋
サカノボリ		瀊
ナゴヤ			名古屋
ミヨシ			三好
アマ			海部
きんき			近畿
みえ			三重
イガ			伊賀
ウノミヤ			鸕宮
シデノキ			枒ノ木
イセ			伊勢
ミナミマタヤマ		南亦山
オワセ			尾鷲
カメヤマ			亀山
ツ			津
ハテ			波氐
トバ			鳥羽
マツザカ			松阪
テイスイ			揥水
ヒツイバラ		椻井原
イナベ			員弁
しが			滋賀
オウミハマン		近江八幡
オオツ			大津
カガタ			笧田
ナガハマ			長浜
アットリザカ		檔鳥坂
メンドリダニ		䳄鳥谷
ヒコネ			彦根
マキノ			牧野
コウガ			甲賀
ウグイガワ		鯎川
ビワコ			琵琶湖
アケンバラ		𡚴原
きょうと			京都
マイズル			舞鶴
ウノ			鸕鷀
タワ			坳
ヒナズカ			雞塚
モジガイチ		文字畾地
ユウケ			涌湗
チャウスヤマ		茶𥓙山
イナナキ			坳
おおさか			大阪
サダ			蹉跎
タカオガミ		高龗
キシワダ			岸和田
ツルハシ			鶴橋
テンノウジ		天王寺
ナンバ			難波
ウメダ			梅田/梅龱
ひょうご			兵庫
ヒチリキ			觱篥
アカシ			明石
アワジ			淡路
ヤギアマノウママワリ	八木天野馬囬
ヤギウママワリ		八木馬回
イズシ			出石
キノサキ			城崎
コウベ			神戸
ジュウゴ			十戸
ヒメジ			姫路
タツノ			龍野
シュクガワ		夙川
トヨオカ			豊岡
ヒジウチ			圡淵/圡渕
なら			奈良
ウネビ			畝傍
カシハラ			橿原
わかやま			和歌山
オオカミダワサン		狼𡴭山
クジノカワ		䦰野川
ノウナギ			野𣷓
エスミ			江住
クシモト			串本
コザ			古座
ゴボウ			御坊
シラハマ			白浜
シングウ			新宮
タイジ			太地
カツラギ			葛城
ミナベ			南部
スサミ			周参見
ちゅうごく		中国
とっとり			鳥取
クラヨシ			倉吉
サカイミナト		境港
しまね			島根
イヅモ			出雲
ヒノミサキ		日御碕
イワミ			石見
ゴウツ			江津
ツワノ			津和野
ハマダ			浜田
マツエ			松江
ヤスギ			安来
タケシマ			竹島
おかやま			岡山
サイ※岡山		穝
サイヒガシマチ		穝東町
クラシキ			倉敷
ツヤマ			津山
スクモヤマ		糘山
ひろしま			広島
クレ			呉
フクヤマ			福山
トモノウラ		鞆の浦
ミヤジマ			宮島
やまぐち			山口
ウベ			宇部
シモノセキ		下関
センザキ			仙崎
ハギ			萩
ヤナイ			柳井
スクモジマ		粭島
しこく			四国
とくしま			徳島
ナルト			鳴門
セト			瀬戸
ムサ			撫佐
ナンコク			南国
ゴメン			後免
ハタエダ			廿枝
ミヨシ			三好
オオボケ			大歩危
ツルギ			剣
ユウマヤマ		木綿麻山
ワジキ			鷲敷
アナン			阿南
シメタニ			〆谷
かがわ			香川
サカイデ			坂出
サヌキ			讃岐
タカマツ			高松
カメオカ			亀阜
ミヨト			三豊
マンノウ			満濃
えひめ			愛媛
イマバリ			今治
ウチコ			内子
ウワジマ			宇和島
オオズ			大洲
シコクチュウオウ		四国中央
ニイハマ			新居浜
マツヤマ			松山
こうち			高知
シマント			四万十
ヌタノカワ		汢の川
スクモ			宿毛
スサキ			須崎
ナカムラ			中村
ムロト			室戸
イノ			伊野
アキ※高知		安芸
ヤナセ			魚梁瀬
きゅうしゅう		九州
ふくおか			福岡
アキヅキ			秋月
イイヅカ			飯塚
クルメ			久留米
コクラ			小倉
ウキハ			浮羽
ミヤコ			京都
アザミ			呰見
ミヤマ			三山
はかた			博多
モジ			門司
ユクハシ			行橋
さが			佐賀
アリタ			有田
イマリ			伊万里
カラツ			唐津
トス			鳥栖
ミヤキ			三養基
ながさき			長崎
サセボ			佐世保
ツシマ			対馬
イキ			壱岐
ジョウガジマ		嫦娥島
くまもと			熊本
アマクサ			天草
ウシブカ			牛深
ヒトヨシ			人吉
コサデガワ		小纚川
ミスミ			三角
ミナマタ			水俣
ユキワリ			膤割
ヤシロ			八代
アサギリ			朝霧
グミガワ			茱莄川
グミサコ			菜莄迫
アソ			阿蘇
アソザン			阿蘇山
ハンタ			𡈽田
おおいた			大分
サイキ			佐伯
タケダ			竹田
ツクミ			津久見
ナカツ			中津
ヒタ			日田
ベップ			別府
ユフイン			湯布院
みやざき			宮崎
オビ			飫肥
サイト			西都
タカチホ			高千穂
ニチナン			日南
ノベオカ			延岡
ヒノカゲ			日之影
ヒュウガ			日向
ミヤコノジョウ		都城
エビノ			蝦野
かごしま			鹿児島
アマミオオシマ		奄美大島
イブスキ			指宿
カノヤ			鹿屋
サクラジマ		桜島
サタ			佐多
タネガシマ		種子島
チラン			知覧
マクラザキ		枕崎
ヤクシマ			屋久島
ミヤノウラ		宮之浦
ナゼ			名瀬
クマガワ			球磨川
イチキクシキノ		市来串木野
おきなわ			沖縄
アカミ			赤嶺
ウルマ			宇流麻
オオギミ			大宜味
ギノワン			宜野湾
キンチョウ		金武
シュリ			首里
ナゴ			名護
ナハ			那覇
モトブ			本部
くだもの			果物
リンゴ			林檎
ナシ			梨
カリン			榠樝
レモン			檸檬
ミカン			蜜柑
グレープフルーツ		葡萄柚
モモ			桃
スモモ			李
カキ※果物		柿
バナナ			甘蕉
ブドウ			葡萄
イチゴ			苺
パイナップル		鳳梨
ザクロ			柘榴
サクランボ		桜桃
マンゴー			檬果
メロン			甜瓜
キウイ			彌猴桃
アボカド			鰐梨
パッションフルーツ	果物時計草
パパイヤ			万寿果/蕃瓜樹
グアバ			蕃石榴
カリン			花梨
ライチ			茘枝
ビワ※果物		枇杷
アセロラ			西印度櫻桃
キンカン			金柑
ユズ			柚子
イチジク			無花果
ヤシ			椰子
くんせい			燻製
サクラ			桜
ヒッコリー		美国山核桃
オーク			楢
ブナ			橅/山毛欅
スギ			杉
カシワ			柏
クヌギ			橡/椚/栩/椢/椪/椡/檪/櫟/櫪/桾/檞/㓛刀
カエデ			楓
ハンノキ			榛の木
ピート			泥炭
やさい			野菜
トマト			蕃茄/赤茄子/唐柿
スイカ			西瓜
キャベツ			球菜/甘藍
ハクサイ			白菜
カボチャ			南瓜
ゴーヤー			苦瓜
チンゲンサイ		青梗菜
ネギ			葱
ニラ			韮
タマネギ			玉葱
ニンニク			大蒜/葫
ラッキョウ		辣韮/薤
シシトウ			獅子唐
トウガラシ		唐辛子
ピーマン			甘唐辛子
チンジャオロース		青椒肉絲
パプリカ			燈籠椒
ハバネロ			哈瓦納辣椒
ホウレンソウ		菠薐草
セリ			芹
ニンジン			人参
ダイコン			大根
ゴボウ			牛蒡
カブ			蕪
ミョウガ			茗荷
ショウガ			生姜
ワサビ			山葵
シソ			紫蘇
ウド			独活
バジル			目箒
サボテン			仙人掌
アロエ			蘆薈
ちゃ			茶
リョクチャ		緑茶
コウチャ			紅茶
ダージリン		大吉岭
セイロン			錫蘭
ウーロンチャ		烏竜茶
はな			花
ブロッコリー		芽花椰菜
カリフラワー		花椰菜
キク			菊
シュンギク		春菊
タンポポ			蒲公英
キュウリ			胡瓜
ナス			茄子
バラ			薔薇
ハッカ			薄荷
ペパーミント		西洋薄荷
カモミール		加密列
マツリ※花		茉莉
ジャスミン		茉莉花
ローズマリー		迷迭香
ウコン			鬱金
ナツメグ			肉豆蒄
カレー			咖喱
たね			種
ウメ			梅
コショウ			胡椒
サンショウ		山椒
カラシ			芥子
あぶら			油
ナノハナ			菜の花
アブラナ			油菜
ハボタン			葉牡丹/甘藍
オリーブ			橄欖
ゴマ			胡麻
ラーユ			辣油
ヒマワリ			向日葵
ベニバナ			紅花
アサ			麻
パーム			棕櫚/椰子
テンプラ			天麩羅
むぎ			麦
コムギ			小麦
コムギコ			小麦粉
フ			麩
パン			麺麭
アンパン	餡麺麭
カレーパン	咖喱麺麭
ショクパン	食麺麭
メロンパン	甜瓜麺麭
ナン			馕
ベーグル			貝果
クロワッサン		牛角面包
ピザ			皮扎餅
ホットケーキ		薄煎餅
オオムギ			大麦
ハッタイコ		糗粉/麨粉
ライムギ			黒麦
オーツムギ		燕麦
オートムギ		燕麦
ソバ			蕎麦
ソーメン			素麺
ヒヤムギ			冷や麦
ウドン			饂飩
ホウトウ			餺飥
キシメン			棊子麺
ラーメン			拉麺
パスタ			意大利麺
マカロニ			管素麺
こめ			米
ゲンマイ			玄米
ウルチマイ		粳米
モチゴメ			糯米
ビーフン			米粉
フォー			米頗/𬖾
もち			餅
センベイ			煎餅
もろこし			蜀黍
トウモロコシ		玉蜀黍
コーン			玉米
コーンスターチ		玉米淀粉
コーンポタージュ		玉米羮
さけ			酒
アルコール		酒精
ビール			麦酒
ウイスキー		火酒
ニホンシュ		日本酒
ウォッカ			伏特加
シャンパン		三変酒/三鞭酒/香檳酒
シャンペン		三変酒/三鞭酒/香檳酒
み			実
クリ			栗
クルミ			胡桃
め			芽
ツクシ			土筆
タケノコ			筍
アスパラガス		石刁柏/竜髭菜
まめ			豆
ダイズ			大豆
トウニュウ		豆乳
ミソ			味噌
アズキ			小豆
アン			餡
アンコ			餡子
ヨウカン			羊羹
チャツウ			楪津宇
ショウユ			醤油
トウバンジャン		豆板醤
エックスオージャン	XO醤
クズ			葛
ソラマメ			空豆/蚕豆
エンドウマメ		豌豆豆
インゲンマメ		隠元豆
サヤエンドウ		鞘豌豆
リョクトウ		緑豆
モヤシ			萌やし
ハルサメ			春雨
コーヒー			珈琲/咖啡
カフェイン		咖啡涅
ピーナッツ		落花生
あわ			粟
ひえ			稗
こうじ			麹
きのこ			茸
ナメコ			滑子
エリンギ			杏鮑菇
マイタケ			舞茸
シメジ			占地
キクラゲ			木耳
トリュフ			西洋松露
マツタケ			松茸
いも			芋
ジャガイモ		加拉巴芋
バレイショ		馬鈴薯
ジネンジョ		自然薯
カタクリコ		片栗粉
サトイモ			里芋
サツマイモ		甘藷
ヤマイモ			山芋
キャッサバ		木薯
タピオカ			西米
とり			鳥
ニワトリ			鶏
ウズラ			鶉
ガチョウ			鵞鳥/鵝鳥
ハト			鳩
ダチョウ			駝鳥
インコ			鸚哥
ウグイス			鶯
ウソ			鷽
ツクネ			捏
ヤンバルクイナ		山原水鶏
どうぶつ			動物
ウシ			牛
ギュウニュウ		牛乳
バター			牛酪
チーズ			乾酪
タロー			牛脂
ブタ			豚
チャーシュー		叉焼
ラード			豚脂
ウサギ			兎
ヒツジ			羊
ウマ			馬
クマ			熊
ヒグマ			羆
コアラ			袋熊
タスマニアデビル		袋熊
ウォンバット		袋熊
バンダ			熊猫
レッサーパンダ		小熊猫
ジャイアントバンダ	大熊猫
カンガルー		長尾驢
イノシシ			猪
ワニ			鰐
ヘビ			蛇
コウモリ			蝙蝠
サメ			鮫
シャチ			鯱
ゼラチン			膠
さかな			魚
マグロ			鮪
サンマ			秋刀魚
マス			鱒
カラフトマス	樺太鱒
ピンクサーモン	樺太鱒
アジ			鯵
アユ			鮎
イワシ			鰯
ウナギ			鰻
アンコウ			鮟
ホッケ			𩸽
カレイ			鰈
ヒラメ			鮃
キス			鱚
コイ			鯉
サバ			鯖
サメ			鮫
シャチ			鯱
スズキ			鱸
ハゼ			鯊
タイ			鯛
タラ			鱈
シシャモ			柳葉魚
ドジョウ※魚		泥鰌/鯲
ナマズ			鯰
ハタハタ			鰰
ハモ			鱧
ハヤ			鮠
ヒラメ			鮃
フナ			鮒
ブリ			鰤
フグ			鰒
イワナ			嘉魚
ボラ			鯔/鰡
マナガツオ		鯧
チリメンジャコ		縮緬雑魚
カツオ			鰹
カツオブシ		鰹節
ニシン			鰊/鯡
サワラ			鰆
カジカ			鰍/杜父魚/鮖
カズノコ			鯑
サケ※魚			鮭
スジコ			筋子
チョウザメ		鱘
キャビア			鱣子/蝶鮫卵
イクラ			鮭卵
イカ			烏賊
タコ			蛸/章魚
ナマコ			海鼠
スシ			寿司/鮨
かいそう			海草/海藻
コンブ			昆布
ノリ			海苔
モズク			藻付/水雲/海蘊/海雲
ヒジキ			鹿尾菜/羊栖菜
オゴノリ			海髪
テングサ			天草
カンテン			寒天
トコロテン		心太/心天/瓊脂
かい※貝類		貝
サザエ			栄螺
アワビ			鮑/鰒
ホタテ			帆立
アサリ			鯏
シジミ			蜆
カキ			牡蠣
ウニ			雲丹
かめ※爬虫類		亀
スッポン			鼈
むし			虫
カニ			蟹
エビ			蝦/蛯/鰕/海老
ヤドカリ			宿借
カタツムリ		蝸牛
バッタ			飛蝗
イナゴ			蝗
セミ			蝉
ヒグラシ			蜩
ヤモリ			守宮
サソリ			蠍
ハチ※昆虫		蜂
スズメバチ		胡蜂
ハチミツ			蜂蜜
カエル			蛙
ホタル			蛍
ひょういもじ		表意文字
ニッポン			日本
チュウゴク		中華人民共和国
タイワン			台湾
ホンコン			香港
ラマトウ			南丫島
チベット			西蔵
モンゴル			蒙古
シャンハイ		上海
マカオ			澳門
シンガポール		新加坡/星加坡
ブラジル			伯刺西爾
ベトナム			越南
キタチョウセン		朝鮮民主主義人民共和国
カンコク			大韓民国
ひょうおんもじ		表音文字
アフガニスタン		阿富汗斯坦
アラブ			亜剌比亜
イエメン			也門
イスラエル		以色列
イラク			伊拉久
イラン			伊蘭
インド			印度
インドネシア		印度尼西亜
ウズベキスタン		月即別
オマーン			阿曼
カザフスタン		香佐富斯坦
カタール			華太瑠
カンボジア		柬埔寨
キルギス			吉爾吉斯
クウェート		科威都
サウジアラビア		沙地亜剌比亜
シリア			叙利亜
スリランカ		錫蘭
タイ			泰
タジキスタン		汰爾奇斯坦
トルクメニスタン		土耳古斯坦
トルコ			土耳古
ネパール			涅巴爾
パキスタン		巴基斯坦
バーレーン		巴林
パレスチナ		巴勒斯坦
バングラデシュ		孟加拉国
ティモール		的木児
フィリピン		比律賓
ブータン			不丹
ブルネイ			文莱
ベトナム			越南
マレーシア		馬来西亜
ミャンマー		緬甸
モルディブ		馬爾代夫
モンゴル			蒙古
ヨルダン			約旦
ラオス			羅宇
レバノン			黎巴嫩
アルジェリア		阿爾及
アンゴラ			諳喀剌
ウガンダ			宇岸陀
エジプト			埃及
エチオピア		哀提伯
エリトリア		厄立特里亜
ガーナ			加納
カーボベルデ		辺瑠出角
ガボン			加蓬
カメルーン		喀麦隆
ガンビア			岡比亜
ギニア			幾内亜
ギニアビサウ		幾内亜美須
ケニア			肯尼亜
コートジボワール		象牙海岸
コモロ			科摩羅
コンゴ			公果
サントメ			聖登米
プリンシペ		不林刺部
ザンビア			山美亜/賛比亜
シエラレオネ		獅子山
ジブチ			吉武地
ジンバブエ		津巴布韋
スーダン			蘇丹
スワジランド		斯威士蘭
セーシェル		塞舌爾
ギニア			幾肉亜
セネガル			塞内牙
ソマリア			蘇摩利亜
タンザニア		坦桑尼亜
チャド			乍得
チュニジア		突尼斯
トーゴ			多哥
ナイジェリア		尼日利亜
ナミビア			納米比亜
ニジェール		尼日爾
ブルキナファソ		布基納法索
ブルンジ			布隆迪
ベナン			貝甯
ボツワナ			博茨瓦納
マダガスカル		馬達加斯加
マラウイ			馬拉維
マリ			麻里
アフリカ			阿弗利加
スーダン			蘇丹
モザンビーク		莫三鼻給
モーリシャス		毛利西亜
モーリタニア		毛里塔尼亜
モロッコ			摩洛哥
リビア			利比亜
リベリア			利比里亜
ルワンダ			路安達
レソト			莱索托
アイスランド		氷蘭
アイルランド		愛蘭
アゼルバイジャン		阿塞拜疆/亞塞拜疆
アルバニア		阿爾巴尼亜
アルメニア		亜美尼亜
アンドラ			安道爾
イギリス			英吉利西/𠸄咭唎
ロンドン			倫敦
イタリア			伊太利亜
ウクライナ		烏克蘭
エストニア		愛沙尼亞
オーストリア		墺太利
オーストリー		墺太利
オランダ			和蘭陀
キプロス			塞浦路斯
ギリシャ			希臘
グルジア			喬治亜
クロアチア		克羅地亜
コソボ			科索沃
サンマリノ		聖馬力諾
スイス			瑞西
スウェーデン		瑞典
スペイン			西班牙
スロバキア		斯洛伐克
スロベニア		斯洛文尼亜
セルビア			塞爾維
チェコ			捷克
デンマーク		丁抹/丹麥
ドイツ			独逸
ノルウェー		諾威
バチカン			和地関
ハンガリー		洪牙利
フィンランド		芬蘭
フランス			仏蘭西
ブルガリア		勃牙利
ベラルーシ		白露西亜
ベルギー			白耳義
ボスニア			波斯尼亜
ヘルツェゴビナ		黒塞哥維那
ポルトガル		葡萄牙
ポーランド		波蘭
マケドニア		馬其頓
マルタ			馬耳他
モナコ			摩納哥
モルドバ			摩爾多瓦
モンテネグロ		黒山
ラトビア			拉脱維亜
リトアニア		立陶宛
リヒテンシュタイン	列支敦士登
ルクセンブルク		盧森堡
ルーマニア		羅馬尼亜
ロシア			露西亜
アメリカ			亜米利加
カリフォルニア		加利福尼亜/加州
ニューヨーク		紐育/紐約
アンティグア		安提瓜
バーブーダ		巴布達
エルサルバドル		救世主国
カナダ			加奈陀
キューバ			玖馬
グアテマラ		危地馬拉
グレナダ			格林納達
コスタリカ		哥斯達利加
ジャマイカ		牙買加
セントクリストファー	聖基茨
ネイビス			尼維斯
セントルシア		聖盧西亜
ドミニカ			土弥尼加
トリニダード		特立尼達
トバゴ			多巴哥
ニカラグア		尼加拉瓦
ハイチ			海地
パナマ			巴奈馬
バハマ			巴哈馬
バルバドス		巴巴多斯
ベリーズ			伯利茲
ホンジュラス		洪都拉斯
メキシコ			墨西哥
アルゼンチン		亜爾然丁
ウルグアイ		宇柳具
エクアドル		哀瓜多
ガイアナ			圭亜那
コロンビア		哥倫比亜
スリナム			蘇里南
チリ			智里
パラグアイ		巴拉圭
ブラジル			伯剌西爾
ベネズエラ		委内瑞拉
ペルー			秘露
ボリビア			墓利比亜
オーストラリア		豪州
キリバス			基里巴斯
サモア			薩摩亜
ソロモン			所羅門
ツバル			津張
トンガ			湯加
ナウル			瑙魯
ニウエ	 		紐埃島
ニュージーランド		新西蘭/乳慈蘭
バヌアツ			瓦努阿図
パプアニューギニア	巴布亜新几内亜
パラオ			帛琉
フィジー			斐済
マーシャル		馬歇爾
ミクロネシア		密克羅尼西亜
トウチャオハンチャンシュエ	独釣寒江雪
にじゅうしせっき		二十四節気
リッシュン		立春
ウスイ			雨水
ケイチツ			啓蟄
シュンブン		春分
セイメイ			清明
コクウ			穀雨
リッカ			立夏
ショウマン		小満
ボウシュ			芒種
ゲシ			夏至
ショウショ		小暑
タイショ			大暑
リッシュウ		立秋
ショショ			処暑
ハクロ			白露
シュウブン		秋分
カンロ			寒露
ソウコウ			霜降
リットウ			立冬
ショウセツ		小雪
タイセツ			大雪
トウジ			冬至
ショウカン		小寒
ダイカン			大寒
しちじゅうにこう		七十二候
ハルカゼコオリヲトク	東風解凍
オウコウケンカンス	黄鶯睍睆
チッチュウハジメテフルウ	蟄虫始振
ウオコオリヲノボル	魚上氷
ウオコオリヲハイズル	魚上氷
ウオコオリニノボル	魚上氷
ウオコオリノイズル	魚上氷
ニコニコサンフラワーキッス	魚氷に上り耀よひて
ツチノショウウルオイオコル	土脉潤起
ダッサイギョ		獺祭魚
カスミハジメテタナビク	霞始靆
コウガンキタル		鴻雁来
ソウモクメバエイズル	草木萠動
スゴモリムシトヲヒラク	蟄虫啓戸
モモハジメテハナサク	桃始華
モモハジメテサク		桃始笑
モモハジメテワラウ	桃始笑
ソウコウナク		倉庚鳴
ナムシチョウトナル	菜虫化蝶
カケシテハトトナル	鷹化為鳩
スズメハジメテスクウ	雀始巣
ツバメキタル		玄鳥至
ゲンチョウイタル		玄鳥至
サクラハジメテヒラク	桜始開
カミナリスナワチコエヲハッス	雷乃発声
ハジメテイナビカリス	始雷
キリハジメテハナサク	桐始華
コウガンカエル		鴻雁北
コウガンキタス		鴻雁北
デンソケシテウズラトナル	田鼠化為鴽
ニジハジメテアラワル	虹始見
アシハジメテショウズ	葭始生
ヨシハジメテショウズ	葭始生
ウキクサハジメテショウズ	萍始生
シモヤミテナエイズル	霜止出苗
シモヤンデナエイズ	霜止出苗
メイキュウソノハネヲハラウ	鳴鳩払其羽
イカルソノハネハラウ	鳴鳩払其羽
ボタンハナサク		牡丹華
タイショウクワニクダル	戴勝降于桑
タイカンクワニクダル	戴勝降于桑
カワズハジメテナク	蛙始鳴
ロウコクナク		螻蟈鳴
ミミズイヅル		蚯蚓出
キュウインイズ		蚯蚓出
タケノコショウズ		竹笋生
オウカショウズ		王瓜生
カイコオキテクワヲハム	蚕起食桑
カイコオコッテクワヲクラウ	蚕起食桑
クサイヒイズ		苦菜秀
ベニバナサカウ		紅花栄
ビソウカル		靡草死
ムギノトキイタル		麦秋至
バクシュウイタル		麦秋至
ショウショイタル		小暑至
カマキリショウズ		螳螂生
トウロウショウズ		螳螂生
クサレタルクサホタルトナル	腐草為蛍
フソウホタルトナル	腐草為蛍
モズハジメテナク		鵙始鳴
ウメノミキバム		梅子黄
ウメノミキナリ		梅子黄
ハンゼツコエナシ		反舌無声
ナツカレクサカルル	乃東枯
シカツノヲオツ		鹿角解
サカシカノツノオル	鹿角解
ロクカクゲ		鹿角解
アヤメハナサク		菖蒲華
ショウブハナサク		菖蒲華
セミハジメテナク		蜩始鳴
ハンゲショウ		半夏生
ハンゲショウズ		半夏生
アツカゼイタル		温風至
ウンプウイタル		温風至
ハスハジメテヒラク	蓮始開
シツシュツカベニオル	蟋蟀居壁
タカスナワチワザヲナス	鷹乃学習
タカスナワチワザヲナラウ	鷹乃学習
キリハジメテハナヲムスブ	桐始結花
キリハジメテハナムスブ	桐始結花
トウシケッカ		桐始結花
ツチウルオウテムシアツシ	土潤溽暑
タイウトキドキニフル	大雨時行
スズカゼイタル		涼風至
リョウフウイタル		涼風至
ヒグラシナク		寒蝉鳴
カンセンナク		寒蝉鳴
ハクロクダル		白露降
フカキキリマトウ		蒙霧升降
モウムショウコウ		蒙霧升降
メンプヒラク		綿柎開
ワタノハナシベヒラク	綿柎開
タカスナワチトリヲマツル	鷹乃祭鳥
タカトリヲマツル		鷹乃祭鳥
テンチハジメテサムシ	天地始粛
テンチハジメテシジム	天地始粛
テンチハジメテシュクス	天地始粛
コクモノスナワチミノル	禾乃登
クワスナワチノボル	禾乃登
クサノツユシロシ		草露白
ソウロシロシ		草露白
セキレイナク		鶺鴒鳴
ゲンチョウカエル		玄鳥帰
ゲンチョウサル		玄鳥去
ツバメサル		玄鳥去
グンチョウシュウヲヤシナウ	羣鳥養羞
カミナリスナワチコエヲオサム	雷乃収声
ライスナワチコエヲオサム		雷乃収声
ムシカクレテトヲフサグ	蟄虫坏戸
チッチュウコヲハイス	蟄虫坏戸
チッチュウトヲトザス	蟄虫坏戸
ミズハジメテカルル	水始涸
ミズハジメテカル		水始涸
コウガンライヒンス	鴻雁来賓
キクノハナヒラク		菊花開
スズメタイスイニイリハマグリトナル		雀入大水為蛤
スズメタイスイニイリコハマグリトナル	雀入大水為蛤
キリギリストニアリ	蟋蟀在戸
シッソクコニアリ		蟋蟀在戸
キクニコウカアリ		菊有黄華
シモハジメテフル		霜始降
サイスナワチケモノヲマツル	豺乃祭獣
コサメトキドキフル	霎時施
ソウモクコウラクス	草木黄落
ソウモクキバミオツル	草木黄落
モミジツタキバム		楓蔦黄
チツチュウミナフス	蟄虫咸俯
チッチュウコトゴトクフス	蟄虫咸俯
ツバキハジメテヒラク	山茶始開
サンチャハジメテヒラク	山茶始開
ミズハジメテコオル	水始氷
チハジメテコオル		地始凍
キンセンカサク		金盞香
ヤケイミズニイリオオハマグリトナル	野鶏入水為蜃
ニジカクレテミエズ	虹蔵不見
キタカゼコノハヲハラウ	朔風払葉
サクフウハヲハラフ	朔風払葉
テンチジョウトウシチカコウス	天気上騰地気下降
テンキジョウトウシチキカコウス	天気上騰地気下降
タチバナハジメテキバム	橘始黄
ヘイソクシテフユヲナス	閉塞而成冬
ヘイソクシテフユトナル	閉塞而成冬
ソラサムクフユトナル	閉塞而成冬
カッチョウナカズ		鶡鳥不鳴
クマアナニコモル		熊蟄穴
クマアナニチッス		熊蟄穴
トラハジメテツルム	虎始交
トラハジメテツルム	武始交
サケノウオムラガル	鱖魚群
ケツギョムラガル		鱖魚群
レイテイイズル		茘挺出
ナツカクレクサショウズ	乃東生
ナイトウショウズ		乃東生
キュウインムスブ		蚯蚓結
サワシカツノオル		麋角解
オオシカノツノオツル	麋角解
ビカクゲス		麋角解
ユキワタリテムギイヅル	雪下出麦
ユキワタリテムギノビル	雪下出麦
セツカムギヲイダス	雪下出麦
スイセンウゴク		水泉動
シミズアタタカヲフクム	水泉動
セリスナワチサカウ	芹乃栄
カリキタニムカウ		雁北郷
カササギハジメテスクウ	鵲始巣
キジハジメテナク		雉始雊
ヤケイハジメテナク	野鶏始雊
フキノハナサク		款冬華
カントウハナサク		款冬華
ニワトリハジメテトヤニツク	鶏始乳
ニワトリハジメテニュウス	鶏始乳
からだ			体
あたま			頭
ノウ			脳
ナンマク			軟膜
クモマク			蜘蛛膜
コウマク			硬膜
ダイノウ			大脳
ゼントウヨウ		前頭葉
ソクトウヨウ		側頭葉
トウチョウヨウ		頭頂葉
コウトウヨウ		後頭葉
ウンドウヤ		運動野
タイセイコンコクヤ	体性感覚野
シカクヤ			視覚野
チョウカクヤ		聴覚野
キュウカクヤ		嗅覚野
ミカクヤ			味覚野
ゲンゴヤ			言語野
ヘントウタイ		偏桃体
カイバ			海馬
カンノウ			間脳
シショウカブ		視床下部
ショウカタイ		松果体
チュウノウ		中脳
イシキ			意識
モウロウ			朦朧
フウテン			瘋癲
フーテン			瘋癲
テンカン			癲癇
カンシャク		癇癪
センモウ			譫妄
カクラン			撹乱
ウツ			鬱
ソウ			躁
ソウウツ			躁鬱
クタビレル		草臥れる
ショウノウ		小脳
エンズイ			延髄
カミ			髪
ケ			毛
モウハツ		毛髪
トウヒ			頭皮
ひふ			皮膚
ハダ			肌
シモン			指紋
シワ			皺
ジュジョウサイボウ	樹状細胞
ホクロ			黶/黒子
ヨウ※皮膚		癰
セツ※皮膚		癤
オデキ			癤
トウヒ			頭皮
かお			顔
メ※体			目
ガンキュウ		眼球
モウマク			網膜
モウテン			盲点
マツゲ			睫
ヒトミ			瞳
マユ			眉
ミケン			眉間
ハナ※体			鼻
ハナゲ			鼻毛
ビコウ			鼻腔
イビキ			鼾
ミミ			耳
ホオ			頬
エクボ			靨
ヒゲ			髭
くち			口
ハ			歯
ケンシ			犬歯
キュウシ			臼歯
オヤシラズ		親知らず
シコウ			歯垢
ハグキ			歯茎
ツバ			唾
ダエキ			唾液
タン			痰
アゴ			顎
オトガイ			頤
くび			首
ウナジ			項
ノド			喉
ヘントウセン		扁桃腺
コウジョウセン		甲状腺
セイタイ			声帯
ハイ※体			肺
ハイホウ			肺胞
オウカクマク		横隔膜
ショクドウ		食道
かた			肩
ウデ			腕
カイナ			肱
ヒジ			肘
タダムキ			臂
て			手
テクビ			手首
テノヒラ			掌
テノコウ			手の甲
ユビ			指
オヤユビ			親指
ヒトサシユビ		人差し指
ナカユビ			中指
クスリユビ		薬指
コユビ			小指
ツメ			爪
ソウコウ			爪甲
ソウカヒ			爪下皮
ソウショウ		爪床
ソウボ			爪母
ソクトウカク		側爪郭
ソウハンゲツ		爪半月
ソウコン			爪根
むね			胸
サコツ			鎖骨
ワキ			腋
チチ			乳
チクビ			乳首
ニュウセン		乳腺
ダイキョウキン		大胸筋
ハイ			肺
ハイセイミャク		肺静脈
シンゾウ			心臓
サシンボウ		左心房
ソウボウベン		僧帽弁
サシンシツ		左心室
ダイドウミャクベン	大動脈弁
ダイドウミャク		大動脈
カンドウミャク		冠動脈
シンキン			心筋
カンセイミャク		冠静脈
ダイセイミャク		大静脈
ウシンポウ		右心房
サンセンベン		三尖弁
ウシンシツ		右心室
ハイドウミャクベン	肺動脈弁
ハイドウミャク		肺動脈
ケッカン			血管
セッケッキュウ		赤血球
ハッッケッキュウ		白血球
ケッショウバン		血小板
タンキュウ		単球
コウチュウキュウ		好中球
マクロファージ		大食細胞
ケッショウ		血漿
ショクドウ		食道
キョウセン		胸腺
せなか			背中
セキツイ			脊椎
セキズイ			脊髄
はら			腹
オナカ			お腹
フッキン			腹筋
ハラヲスエル		肚を据える
ハラダヌキ		肚貍
ゴゾウロップ		五臓六腑
ミゾオチ		鳩尾
ヘソ			臍
イ			胃
ジュウニシチョウ		十二指腸
カンゾウ			肝臓
ヒゾウ			脾臓
リンパ			淋巴
リンパキュウ		淋巴球
タンノウ			胆嚢
ショウチョウ		小腸
モウチョウ		盲腸
ダイチョウ		大腸
コウモン			肛門
こし			腰
ジンゾウ			腎臓
ボウコウ			膀胱
ニョウドウ		尿道
マタ			股
コツバン			骨盤
ツイカンバン		椎間板
コカンセツ		股関節
ランソウ			卵巣
セイソウ			精巣
シキュウ			子宮
ゼンリツセン		前立腺
クリトリス		陰核
カイメンタイ		海綿体
ダイインシン		大陰唇
インノウ			陰嚢
モモ※体			腿
フトモモ			太腿
ダイタイコツ		大腿骨
ヒザ			膝
ハンゲツバン		半月板
スネ			脛
フクラハギ		脹脛
クルブシ			踝
ベンケイノナキドコロ	弁慶の泣き所
アキレスケン		アキレス腱
ショウコツケン		踵骨腱
カカト			踵
キビス			踵
ガイハンボシ		外反母趾
ツマサキ			爪先
いろ			色
サクライロ		桜色
アズキイロ		小豆色
コガネ			黄金
モエギイロ		萌葱色
コダイムラサキ		古代紫
ウスザクラ		薄桜
カラチャ			枯茶
ハジゾメ			櫨染
ハナロクショウ		花緑青
ナスコン			茄子紺
サクラネズ		桜鼠
アメイロ			飴色
キクチバイロ		黄朽葉色
ヒスイイロ		翡翠色
フタアイ			二藍
トキネズ			鴇鼠
ラクダイロ		駱駝色
ヤマブキチャ		山吹茶
アオミドリ		青緑
キョウムラサキ		京紫
ニジイロ			虹色
ツチイロ			土色
カラシイロ		芥子色
ミズアサギ		水浅葱
エビゾメ			蒲葡
サンゴイロ		珊瑚色
キガラチャ		黄唐茶
マメガラチャ		豆萁茶
サビアサギ		錆浅葱
ワカムラサキ		若紫
イッコンゾメ		一斤染
クワゾメ			桑染
キクジン			麹塵
セイヘキ			青碧
ベニムラサキ		紅紫
シシイロ			宍色
ハジイロ			櫨色
ヤマバトイロ		山鳩色
オメシチャ		御召茶
ウメムラサキ		梅紫
コウバイイロ		紅梅色
キツルバミ		黄橡
リキュウネズミ		利休鼠
ミナトネズミ		湊鼠
アヤメイロ		菖蒲色
ウスベニ			薄紅
チョウジゾメ		丁字染
ミルチャ			海松茶
コウライナンド		高麗納戸
ベニフジイロ		紅藤色
ジンザモミ		甚三紅
コウゾメ			香染
アイミルチャ		藍海松茶
モモシオチャ		百入茶
アサムラサキ		浅紫
モモイロ			桃色
ビワチャ			枇杷茶
アイコビチャ		藍媚茶
サビネズ			錆鼠
ムラサキスイショウ	紫水晶
トキイロ			鴇色
シカンチャ		芝翫茶
センサイチャ		千歳茶
サビテツオナンド		錆鉄御納戸
ウスウメネズ		薄梅鼠
ナデシコイロ		撫子色
コガレコウ		焦香
イワイチャ		岩井茶
アイネズ			藍鼠
アカツキネズ		暁鼠
ハイウメ			灰梅
クルミイロ		胡桃色
センサイチャ		仙斎茶
サビオナンド		錆御納戸
ボタンネズ		牡丹鼠
ハイザクラ		灰桜
シブカミイロ		渋紙色
クロミドリ		黒緑
マスハナイロ		舛花色
カスミイロ		霞色
アワベニフジ		淡紅藤
クチバイロ		朽葉色
ヤナギススタケ		柳煤竹
ノシメハナイロ		熨斗目花色
フジネズ			藤鼠
セキチクイロ		石竹色
クワチャ			桑茶
カバチャイロ		樺茶色
オメシオナンド		御召御納戸
ハシタイロ		半色
ウスコウバイ		薄紅梅
ロコウチャ		路考茶
ウツブシイロ		空五倍子色
テツオナンド		鉄御納戸
ウスイロ			薄色
モモハナイロ		桃花色
コクボウショク		国防色
ナマカベイロ		生壁色
コンネズ			紺鼠
ウスネズ			薄鼠
ミズガキ			水柿
キャライロ		伽羅色
ヒゴススタケ		肥後煤竹
アイテツ			藍鉄
ハトバネズミ		鳩羽鼠
トキガラチャ		鴇柄茶
エドチャ			江戸茶
コビチャ			媚茶
アオカチ			青褐
ハトバイロ		鳩羽色
アラゾメ			退紅
カバイロ			樺色
シロツルバミ		白橡
カチカエシ		褐返
キキョウネズ		桔梗鼠
ウスガキ			薄柿
ベニウコン		紅鬱金
アマイロ			亜麻色
カチイロ			褐色
ムラサキネズ		紫鼠
チョウシュンイロ		長春色
カワラケイロ		土器色
ハシバミイロ		榛色
ゲッパク			月白
ブドウネズミ		葡萄鼠
ウメネズ			梅鼠
キツネイロ		狐色
アクイロ			灰汁色
シロスミレイロ		白菫色
コキイロ			濃色
トキアサギ		鴇浅葱
オウドイロ		黄土色
リキュウチャ		利休茶
シラハナイロ		白花色
ムラサキトビ		紫鳶
ウメゾメ			梅染
コハクイロ		琥珀色
ウグイスチャ		鶯茶
アイジロ			藍白
コイネズ			濃鼠
スオウコウ		蘇芳香
アカチャ			赤茶
モクランジキ		木蘭色
シラアイ			白藍
フジススタケ		藤煤竹
アサスオウ		浅蘇芳
タイシャ			代赭
スナイロ			砂色
ミズイロ			水色
ケシムラサキ		滅紫
マソオ			真朱
レンガイロ		煉瓦色
アブライロ		油色
カメノゾキ		瓶覗
ベニケシネズミ		紅消鼠
アカムラサキ		赤紫
スズメチャ		雀茶
リキュウイロ		利休色
ヒソクイロ		秘色色
ニセムラサキ		偐紫
ツツジイロ		躑躅色
ダンジュウロウチャ	団十郎茶
バイコウチャ		梅幸茶
ソライロ			空色
ハイキミドリ		灰黄緑
ボタンイロ		牡丹色
カキシブイロ		柿渋色
リカンチャ		璃寛茶
ワスレナグサイロ		勿忘草色
ソバキリイロ		蕎麦切色
イマヨウイロ		今様色
ベニトビ			紅鳶
キミルチャ		黄海松茶
アオフジイロ		青藤色
ウスクモネズ		薄雲鼠
ナカベニ			中紅
ハイチャ			灰茶
ナタネユイロ		菜種油色
ビャクグン		白群
カレノイロ		枯野色
バライロ			薔薇色
チャイロ			茶色
アオクチバ		青朽葉
アサハナダ		浅縹
ウルミイロ		潤色
カラクレナイ		韓紅
ヒワダイロ		檜皮色
ネギシイロ		根岸色
ウスハナイロ		薄花色
リキュウシロチャ		利休白茶
ギンシュ			銀朱
トビイロ			鳶色
ヒワチャ			鶸茶
ナンドイロ		納戸色
チャネズミ		茶鼠
アカベニ			赤紅
カキチャ			柿茶
ヤナギチャ		柳茶
アサギイロ		浅葱色
クルミゾメ		胡桃染
ベニヒ			紅緋
ベンガライロ		弁柄色
ミルイロ			海松色
ハナアサギ		花浅葱
エドネズ			江戸鼠
アカ			赤
アカサビイロ		赤錆色
ウグイスイロ		鶯色
シンバシイロ		新橋色
ススイロ			煤色
ショウジョウヒ		猩々緋
カッショク		褐色
リョクオウショク		緑黄色
アマイロ			天色
チョウジチャ		丁子茶
クレナイ			紅
クリウメ			栗梅
ヒワイロ			鶸色
ツユクサイロ		露草色
フシゾメ			柴染
コキヒ			深緋
ベニヒハダ		紅檜皮
マッチャイロ		抹茶色
アオ			青
ソウデンカラチャ		宗伝唐茶
ヒイロ			緋色
エビチャ			海老茶
ワカクサイロ		若草色
ウスアイ			薄藍
トノチャ			砺茶
アカニ			赤丹
カラチャ			唐茶
キミドリ			黄緑
ハナダイロ		縹色
センチャイロ		煎茶色
ベニアカ			紅赤
クリイロ			栗色
ワカメイロ		若芽色
コンペキ			紺碧
ギンススダケ		銀煤竹
エンジ			臙脂
シャクドウイロ		赤銅色
ワカナイロ		若菜色
ウスグンジョウ		薄群青
キガラチャ		黄枯茶
アケ			朱/緋
サビイロ			錆色
ワカナエイロ		若苗色
ウスハナザクラ		薄花桜
ススタケイロ		煤竹色
アカネイロ		茜色
セッカッショク		赤褐色
アオニ			青丹
グンジョウイロ		群青色
コゲチャ			焦茶
ベニエビチャ		紅海老茶
チャカッショク		茶褐色
クサイロ			草色
カキツバタイロ		杜若色
クロツルバミ		黒橡
スオウ			蘇芳
クリカワチャ		栗皮茶
コケイロ			苔色
ルリイロ			瑠璃色
ケンポウイロ		憲法色
シンク			真紅
クロチャ			黒茶
モエギ			萌黄
ウスハナダ		薄縹
クリイロ			涅色
コイクレナイ		濃紅
エビチャ			葡萄茶
ナエイロ			苗色
ルリコン			瑠璃紺
ビンロウジゾメ		檳榔子染
ゾウゲイロ		象牙色
エビイロ			葡萄色
ワカバイロ		若葉色
コンルリ			紺瑠璃
クロトビ			黒鳶
ネリイロ			練色
カンゾウイロ		萱草色
マツバイロ		松葉色
アイイロ			藍色
アカスミ			赤墨
カイハクショク		灰白色
コウジイロ		柑子色
ナツムシイロ		夏虫色
セイラン			青藍
クロベニ			黒紅
ムシグリイロ		蒸栗色
キンチャ			金茶
ヒワモエギ		鶸萌黄
コキハナダ		深縹
シロ			白
オミナエシ		女郎花
ミカンイロ		蜜柑色
ヤナギイロ		柳色
コンイロ			紺色
ゴフンイロ		胡粉色
カレクサイロ		枯草色
エンタンイロ		鉛丹色
アオシロツルバミ		青白橡
コンジョウ		紺青
ウノハナイロ		卯ノ花色
タンコウ			淡黄
オウニ			黄丹
ヤナギネズ		柳鼠
トメコン			留紺
ハクジ			白磁
シラチャ			白茶
カキイロ			柿色
ウラハヤナギ		裏葉柳
コイアイ			濃藍
キナリイロ		生成色
アカシロツルバミ		赤白橡
キアカ			黄赤
ワサビイロ		山葵色
テツコン			鉄紺
ニュウハクショク		乳白色
アライガキ		洗柿
ニンジンイロ		人参色
オイタケイロ		老竹色
シッコク			漆黒
シロネリ			白練
トリノコイロ		鳥ノ子色
ダイダイイロ		橙色
ビャクロク		白緑
アワフジイロ		淡藤色
ソショク			素色
ハチミツイロ		蜂蜜色
テリガキ			照柿
ウスモエギ		淡萌黄
フジイロ			藤色
シラウメネズ		白梅鼠
ハダイロ			肌色
アカダイダイ		赤橙
ヤナギゾメ		柳染
ベニカケソライロ		紅掛空色
シロネズ			白鼠
ウスタマゴイロ		薄卵色
キンアカ			金赤
ウスモエギ		薄萌葱
ベニミドリ		紅碧
キヌネズ			絹鼠
ユウオウ			雄黄
シュイロ			朱色
フカガワネズミ		深川鼠
コンキキョウ		紺桔梗
ハイアオ			灰青
シャレガキ		洒落柿
コムギイロ		小麦色
ワカミドリ		若緑
ハナイロ			花色
ギンネズ			銀鼠
アカコウ			赤香
ニイロ			丹色
アサミドリ		浅緑
コンアイ			紺藍
ウスニビ			薄鈍
トノコイロ		砥粉色
キチャ			黄茶
ウスミドリ		薄緑
ベニキキョウ		紅桔梗
ウスズミイロ		薄墨色
ニクイロ			肉色
ニッケイイロ		肉桂色
アオニビ			青鈍
キキョウイロ		桔梗色
スズイロ			錫色
ヒトイロ			人色
アカクチバイロ		赤朽葉色
セイジネズ		青磁鼠
フジナンド		藤納戸
スネズミ			素鼠
チョウジイロ		丁子色
コウロゼン		黄櫨染
ウスアオ			薄青
ベニカケハナイロ		紅掛花色
ネズミイロ		鼠色
コウイロ			香色
タンポポイロ		蒲公英色
サビセイジ		錆青磁
シオンイロ		紫苑色
ゲンジネズ		源氏鼠
ウスコウ			薄香
キイロ			黄色
ロクショウイロ		緑青色
シラフジイロ		白藤色
ハイイロ			灰色
ウスキ			浅黄
チュウキ			中黄
チトセミドリ		千歳緑
フジムラサキ		藤紫
ナマリイロ		鉛色
カレイロ			枯色
ナノハナイロ		菜の花色
ワカタケイロ		若竹色
スミレイロ		菫色
ニビイロ			鈍色
ウスコウ			淡香
キハダイロ		黄檗色
ミドリ			緑
アオムラサキ		青紫
スミ			墨
アンズイロ		杏色
タマゴイロ		卵色
トキワイロ		常磐色
ショウブイロ		菖蒲色
ドブネズミ		丼鼠
シノノメイロ		東雲色
ハナバイロ		花葉色
チグサネズ		千草鼠
リンドウイロ		竜胆色
ケシズミイロ		消炭色
アケボノイロ		曙色
カリヤスイロ		刈安色
チグサイロ		千草色
エドムラサキ		江戸紫
アイスミチャ		藍墨茶
サンゴシュイロ		珊瑚朱色
トウモロコシイロ		玉蜀黍色
セイジイロ		青磁色
ホンムラサキ		本紫
ヨウカンイロ		羊羹色
コキクチナシ		深支子
カナリアイロ		金糸雀色
アオタケイロ		青竹色
ブドウイロ		葡萄色
ロウイロ			蝋色
ソヒ			纁
キクチナシイロ		黄支子色
トキワミドリ		常磐緑
フカムラサキ		深紫
クロ			黒
ウスキヒ			浅緋
クチナシイロ		支子色
トクサイロ		木賊色
シコク			紫黒
カラスバイロ		烏羽色
マソホ			真赭
ヒマワリイロ		向日葵色
ビロウド			天鵞絨/天鵝絨
テンガジュウ		天鵞絨/天鵝絨
ムラサキ			紫
テツグロ			鉄黒
アライシュ		洗朱
ヤマブキイロ		山吹色
ムシアオ			虫襖
ウスブドウ		薄葡萄
ヌレバイロ		濡羽色
エンシュウチャ		遠州茶
ウコンイロ		鬱金色
カワイロ			革色
シコン			紫紺
コクタン			黒檀
ベニカバイロ		紅樺色
トウオウ			藤黄
フカミドリ		深緑
アンコウショク		暗紅色
ケンポウクロチャ		憲法黒茶
ソホ			赭
コンジキ			金色
テツイロ			鉄色
クワノミイロ		桑の実色
アンコクショク		暗黒色
シアン			氰
ピンク			桃紅
マゼンタ			品紅
がっき			楽器
ビワ※楽器		琵琶
シャミセン		三味線
ジャミセン		蛇味線/蛇皮線/三味線
サンシン			三線
バイオリン		提琴
ヴァイオリン		提琴
アコーディオン		手風琴
オルガン			風琴
オルゴール		自鳴琴
ハーモニカ		口風琴
ラッパ			喇叭
サイコロ			賽子/骰子
ウチワ			団扇
ボイラー			汽罐
すぽーつ			運動/競技
テーブルテニス		卓球
タッキュウ		卓球
タッキュー		卓球
サッカー			蹴球
シュウキュウ		蹴球
テニス			庭球
テイキュウ		庭球
テーキュウ		庭球
ベースボール		野球
ヤキュウ			野球
ヤキュー			野球
バレーボール		排球
ハイキュウ		排球
ハイキュー		排球
バスケットボール		籠球
ロウキュウ		籠球
ローキュー		籠球
ゴルフ			孔球
ボウリング		十柱戯/柱技
ボーリング		十柱戯/柱技
アメリカンフットボール	鎧球
アメフト			鎧球
ガイキュウ		鎧球
ガイキュー		鎧球
ビリヤード		撞球
ドウキュウ		撞球
ドウキュー		撞球
ドッジボール	避球/飛球
ゲートボール	門球
バドミントン	羽球
アイスホッケー	氷球
スイキュウ		水球
スイキュー		水球
ウォーターポロ	水球
ホッケー			杖球
ジョウキュウ		杖球
ラグビー			闘球
トウキュウ		闘球
トウキュー		闘球
ゲートボール		門球
モンキュウ		門球
モンキュー		門球
ハンドボール		送球
ソウキュウ		送球
ソウキュー		送球
バドミントン		羽球
ウキュウ			羽球
ウキュー			羽球
ドッジボール		避球
ヒキュウ			避球
ヒキュー			避球
アイスホッケ		氷球
ヒョウキュウ		氷球
ヒョウキュー		氷球
ボクシング		拳闘
ケントウ			拳闘
ケンドウ			剣道
キュウドウ		弓道
ジュウドウ		柔道
アイキドウ		合気道
サドウ			茶道
チャドウ			茶道
ショドウ			書道
しゅざん			珠算
ソロバン			算盤
デンタク			電卓
ケイサンジャク			計算尺
ジョウギ			定規
コンパス			円規
エンキ				円規
ブンドキ			分度器
ヒッサン			筆算
アンザン			暗算
クク			九九
ヘイホウコン		平方根
カイヘイホウ		開平法
カイリツホウ		開立法
カイリュウホウ		開立法
バイコンホウ		倍根法
リッポウクク		立方九九
ゴワサン		御破算
しょうぎ		将棋
将棋 ☖☗歩と香杏桂圭銀全金角馬飛竜玉王⛉⛊
フ※将棋		歩
フヒョウ		歩兵
トキン			と金
キョウシャ		香車
ナリキョウ		成香
ケイマ			桂馬
ナリケイ		成桂
ギンショウ		銀将
ナリギン		成銀
キンショウ		金将
カクギョウ		角行
リュウマ		竜馬
ヒシャ			飛車
リュウオウ		竜王
オウショウ		王将
ギョクショウ	玉将
ナリゴマ		成駒
フナリ			不成
ナラズ			不成
オウテ			王手
ウチフズメ		打ち歩詰め
ニフ			二歩
ツキフズメ		突き歩詰め
センニチテ		千日手
ニュウギョク		入玉
ジショウギ		持将棋
いご			囲碁
フセキ			布石
ジョウセキ		定石
テンゲン		天元
コウ			劫
ヤオチョウ		八百長
シカツ			死活
ロクシハッカツ		六死八活
スミノマガリヨンモク	隅のマガリ四目
スミノマガリシモク	隅のマガリ四目
タイキョクカン		大局観
モクサン		目算
トウリョウ		投了
ちぇす			西洋棋
西洋棋			♔♕♖♗♘♙王妃塔僧騎歩♚♛♜♝♞♟
さいころ		賽子
賽子			⚀⚁⚂⚃⚄⚅
まーじゃん		麻雀
麻雀	🀀🀁🀂🀃🀄🀅🀆🀇🀈🀉🀊🀋🀌🀍🀎🀏🀐🀑🀒🀓🀔🀕🀖🀗🀘🀙🀚🀛🀜🀝🀞🀟🀠🀡🀢🀣🀤🀥🀦🀧🀨🀩🀪🀫
マンズ			萬子
ワンズ			萬子
イーワン		一萬
リャンワン		二萬
サンワン		三萬
スーワン		四萬
ウーワン		五萬
ローワン		六萬
チーワン		七萬
パーワン		八萬
キューワン		九萬
ソーズ			索子
イーソー		一索
リャンソー		二索
サンソー		三索
スーソー		四索
ウーソー		五索
ローソー		六索
チーソー		七索
パーソー		八索
キューソー		九索
ピンズ			筒子
イーピン		一筒
リャンピン		二筒
サンピン		三筒
スーピン		四筒
ウーピン		五筒
ローピン		六筒
チーピン		七筒
パーピン		八筒
キューピン		九筒
メンツ			面子
シュンツ		順子
コーツ			刻子
ジャントウ		雀頭
フーロ			副露
クイサガリ		喰い下がり
メンゼン		門前
ポン			碰
チー			吃
カン			槓
トイ			対
テンパイ		聴牌
イーシャンテン		一向聴
フ※麻雀		符
ハン			翻
リーチ			立直
タンキ			単騎
リャンメン		両面
シャンポン		双碰
ペンチャン		辺張
カンチャン		嵌張
ツモ			自摸
ロン			栄
イッパツ			一発
ホーラ			和了
テンホウ			天和
レンホウ			人和
チーホウ			地和
マンガン		満貫
ナガシマンガン		流し満貫
ハネマン	ハネ満
バイマン	倍満
サンバイマン	3倍満
ヤクマン	役満
ダブルマン	Ｗ役満
メンゼンチンツモホウ	門前清自摸和
メンゼンツモ		門前清自摸和
タンヤオ			断么
タンヤオチュー		断么九
ピンフ			平和
イーペーコー		一盃口
ヤクハイ			役牌
ハンパイ			飜牌
リンシャンカイホウ	嶺上開花
チャンカン		槍槓
リャンゾーチャンカン		二索槍槓
ハイテイモーユエ		海底摸月
ハイテイ			海底摸月
ホーテイラオユイ		河底撈魚
ホーテイ			河底撈魚
イーピンラオユエ	一筒撈月
チューピンラオユイ	九筒撈魚
ウーピンカイホー	五筒開花
リャンゾーチャンカン	二索搶槓
サンショクドウジュン	三色同順
イッキツウカン		一気通貫
ホンチャンタイヤオチュー	混全帯么九
ジュンチャンタイヤオチュー	純全帯么九
チートイツ		七対子
サンゲンチートイツ	三元七対子
スーシーチートイツ	四喜七対子
アメリカンチートイツ	アメリカン七対子
トイトイホー		対々和
トイトイ		対々和
サンアンコー		三暗刻
ホンロウトー		混老頭
サンショクドーコー	三色同刻
サンカンツ		三槓子
ショウサンゲン		小三元
ダブルリーチ		二重立直
ホンイーソー		混一色
リャンペーコー		二盃口
チンイーソー		清一色
コクシムソウ		国士無双
スーアンコー		四暗刻
ダイサンゲン		大三元
ツーイーソー		字一色
ショウスーシー		小四喜
ダイスーシー		大四喜
リューイーソー		緑一色
チンロートー		清老頭
スーカンツ		四槓子
チューレンポウトー	九蓮宝燈
サンレンコー		三連刻
スーレンコー		四連刻
ダイシャリン		大車輪
ショウシャリン		小車輪
ダイチクリン		大竹林
ダイスウリン		大数隣
ベニクジャク		紅孔雀
コウイッテン		紅一点
リューイーソーリン	緑一色輪
コクイーソー		黒一色
ヘイイーソー		黒一色
タンフォンホー		断紅和
ヒャクマンゴク		百万石
カガヒャクマンゴク		加賀百万石
キシュウゴジュウゴマンゴク	紀州五十五万石
ミトサンジュウゴマンゴク	水戸三十五万石
イーソーサンシュン	一色三順
イーソースーシュン	一色四順
シーサンプータ		十三不塔
シーサンプトウ		十三不塔
シーサンウーシー		十三無靠
チーシンウーシー		七星無靠
パーレンチャン		八連荘
ポーホイパーレンチャン	破回八連荘
ペーヨンジュン		北四順
オタカゼサンコー		客風三刻
サンプウコー		三風刻
スーツーコー		四字刻
フウカセツゲツ		風花雪月
カチョウフウゲツ		花鳥風月
トウホクシンカンセン	東北新幹線
トウホクシンカンセングリーンシャ	東北新幹線グリーン車
トウホクジドウシャドウ	東北自動車道
セイカンレンラクセン		青函連絡船
ナンボクセンソウ		南北戦争
ゴールデンゲートブリッジ	金門橋
アオノドウモン		青ノ洞門
ウーメンチー		五門斉
マネマン			真似満
トウカンホー		頭槓和
レンカイホウ		連開花
ウーピンカイホウ		五筒開花
ダイチーシン		大七星
チンペーコー		清盃口
シャンロンチョンチュ	双竜争珠
キャンドンホー		鏡同和
リャンドーコー		二同刻
ウーシンツウカン		五心通貫
イッキツウカンチャンタイヤオチュウ		一気通貫全帯么九
ジュンイッキツウカンチャンタイヤオチュウ	純一気通貫全帯么九
サンショクツウカン	三色通貫
タンロン			単竜
サンショクレンコー	三色連刻
チョウサンコウ		頂三刻
チョウパイコー		跳牌刻
スジパイコー		筋牌刻
シーアルラオタイ		十二落抬
チンチトウリイ		金鶏独立
アンカン		暗槓
ダイミンカン		大明槓
ショウミンカン		小明槓
カカン			加槓
カンブリ		槓振
リュウキョク		流局
チョンボ		錯和
ノーテン		不聴
バップ			罰符
キュウシュキュウハイ	九種九牌
スーカイカン		四開槓
スーカンサンラ		四槓散了
スーカンサンラ		四槓算了
スーチャリーチ		四家立直
サンチャホー		三家和
スーフーレンダ		四風連打
てんき			天気
カイセイ			快晴
ハレ			晴
ウスグモリ		薄曇
クモリ			曇
エンム			煙霧
スナアラシ		塵嵐
サジンアラシ		砂塵嵐
オオヤマジ		大山嵐
フブキ			吹雪
ジフブキ			地吹雪
キリ			霧
キリサメ			霧雨
アメ※天気		雨
ミゾレ			霙
アラレ			霰
ユキ			雪
ヒョウ※天気		雹
カミナリ			雷
シンキロウ		蜃気楼
げんそ			元素
元素	氫氦鋰鈹硼碳氮氧氟氖鈉鎂鋁矽磷硫氯氬鉀鈣鈧鈦釩鉻錳鐵鈷鎳銅鋅鎵鍺砷硒溴氪銣鍶釔鋯鈮鉬鎝釕銠鈀銀鎘銦錫銻碲碘氙銫鋇鑭鈰鐠釹鉕釤銪釓鋱鏑鈥鉺銩鐿鎦鉿鉭鎢錸鋨銥鉑金汞鉈鉛鉍釙砈氡鍅鐳錒釷鏷鈾錼鈽鋂鋦鉳鉲鑀鐨鍆鍩鐒鑪𨧀𨭎𨨏𨭆䥑鐽錀鎶
スイソ			水素
ハイドロゲン		氫
ヘリウム			氦
リチウム			鋰
ベリリウム		鈹
ホウソ			硼素
ボロニウム		硼
タンソ			炭素
カーボン			碳
チッソ			窒素
ニトロゲン		氮
オキシゲン		氧
オキシジェン		氧
フッソ			弗素
フローリン		氟
フローライド		氟
ネオン			氖
ナトリウム		鈉
ナトリュウム		那篤𠌃謨
マグネシウム		鎂
マグネシュウム		麻倔涅叟謨
アルミ			軽銀
アルミニウム		鋁
アルミニュウム		亞爾密紐謨
ケイソ			珪素
シリコン			矽
リン			燐
リン※元素		磷
フォスフォラス		磷
マッチ			燐寸
イオウ			硫黄
イオウ※元素		硫
サルファー		硫
エンソ			塩素
クロリン			氯
アルゴン			氬
カリウム			鉀
カリュウム		加𠌃謨
カルシウム		鈣
カルシュウム		加爾叟謨
スカンジウム		鈧
チタン			鈦
バナジウム		釩
クロム			鉻
マンガン			錳
テツ			鉄
クロガネ			黒鉄
アイロン			鐵
コバルト			鈷
ニッケル			鎳
ドウ			銅
カッパー			銅
コッパー			銅
アエン			亜鉛
ジンク			鋅
ジンカム			鋅
ガリウム			鎵
ゲルマニウム		鍺
ヒソ			砒素
アルセニック		砷
セレン			硒
シュウソ			臭素
ブローミン		溴
クリプトン		氪
ルビジウム		銣
ストロンチウム		鍶
イットリウム		釔
ジルコニウム		鋯
ジルコニア		氧化鋯
ニオブ			鈮
モリブデン		鉬
テクネチウム		鎝
ルテニウム		釕
ロジウム			銠
パラジウム		鈀
ギン			銀
シルバー			銀
しろがね			白銀
カドミウム		鎘
インジウム		銦
スズ			錫
ティン			錫
ピューター		錫
アンチモン		銻
テルル			碲
ヨウソ			沃素
ヨード			沃度
アイオダイン		碘
キセノン			氙
セシウム			銫
バリウム			鋇
ランタン			鑭
セリウム			鈰
プラセオジム		鐠
ネオジム			釹
プロメチウム		鉕
サマリウム		釤
ユウロピウム		銪
ガドリニウム		釓
テルビウム		鋱
ジスプロシウム		鏑
ホルミウム		鈥
エルビウム		鉺
ツリウム			銩
イッテルビウム		鐿
ルテチウム		鎦
ハフニウム		鉿
タンタル			鉭
タングステン		鎢
レニウム			錸
オスミウム		鋨
イリジウム		銥
ハッキン			白金
プラチナ			鉑
キン			金
ゴールド			金
スイギン			水銀
マーキュリー		汞
タリウム			鉈
ナマリ			鉛
レッド※元素		鉛
ビスマス			鉍
ポロニウム		釙
アスタチン		砈
ラドン			氡
フランシウム		鍅
ラジウム			鐳
アクチニウム		錒
トリウム			釷
プロトアクチニウム	鏷
ウラン			鈾
ネプツニウム		錼
プルトニウム		鈽
アメリシウム		鋂
キュリウム		鋦
バークリウム		鉳
カリホルニウム		鉲
アインスタイニウム	鑀
フェルミウム		鐨
メンデレビウム		鍆
ノーベリウム		鍩
ローレンシウム		鐒
ラザホージウム		鑪
ドブニウム		𨧀
シーボーギウム		𨭎
ボーリウム		𨨏
ハッシウム		𨭆
マイトネリウム		䥑
ダームスタチウム		鐽
レントゲニウム		錀
コペルニシウム		鎶
なんだかとっても！いいかんじ	http://www.nicovideo.jp/watch/sm3604366
ヤマノウエニヒトガイルサマ	仚
ワレヲワスレル			嗒
タマヲミガクショクニン		玊
アシヲブラブラサセテコシカケル	呮
クサキガチヲハッテハエテイル	𡔉
ブツブツツブヤク			嘟
ヒキコモル			扃
ヒサシクナオラナイヤマイ		痼
サケヲススメル			䤐
ヒカエメニスル			嗇
メデタイクモ			霱
ムジツノツミ			枉
トリノカナシゲナコエ		嚌
オトシアナニオトス		臽
モノカゲカラキュウニトビダシテヒトヲオドロカセルトキニハッスルコエ	閄
キョロキョロミマワス		𥇛
マバタキシナイ			䁶
ワラオウトスル			𠱐
メガマワル			𥆞
ブリザード			𫙹
フネガシズム			𠤾
セマリクルアラナミ		𩏊
ココロガセマイ			狷
オオカゼノオコルサマ		飍
コメヲタクワエルウツワ		𤲑
タケノコノツケモノ		𥰮
ウシノアユミガオソイ		㸪
ブタノコ				㹠
ブタノハハ			𤟃
アルキカタガタダシクナイ		𤮳
トショカン			圕
マボロシ				𠄔
ウマガススム			馾
ウマガナヤム			駗
ウマガオトナシイ			𩤠
ウマガオモイ			驇
ウマガオドル			驣
ウマガハネル			驧
ウマガアガク			駶
ウマヲアラウ			𤀤
ウマガオドロク			䭹
ウマガユク			𩡨
アゴガシャクレル			顉
チョットミル			眱
クリプトン			氪
ハリツケニスル			搏
ヤマガタカクケワシイ		瘣
マルクナイタマ			𤪫
モノカゲカラキュウニトビダシテヒトヲオドロカセルトキニハッスルコエ	閄
ホネガノドニツッカエル		鯁
オオワライスルサマ		辴
チラリトミル			䀸
マッスグニテンクウタカクトビアガル	翀
オトリノシカ			𪋗
ギョクノイロツヤノスバラシイサマ	璱
シソンガサカエル			孮
こうきじてん	康熙字典
康熙字典			⼀⼁⼂⼃⼄⼅⼆⼇⼈⼉⼊⼋⼌⼍⼎⼏⼐⼑⼒⼓⼔⼕⼖⼗⼘⼙⼚⼛⼜⼝⼞⼟⼠⼡⼢⼣⼤⼥⼦⼧⼨⼩⼪⼫⼬⼭⼮⼯⼰⼱⼲⼳⼴⼵⼶⼷⼸⼹⼺⼻⼼⼽⼾⼿⽀⽁⽂⽃⽄⽅⽆⽇⽈⽉⽊⽋⽌⽍⽎⽏⽐⽑⽒⽓⽔⽕⽖⽗⽘⽙⽚⽛⽜⽝⽞⽟⽠⽡⽢⽣⽤⽥⽦⽧⽨⽩⽪⽫⽬⽭⽮⽯⽰⽱⽲⽳⽴⽵⽶⽷⽸⽹⽺⽻⽼⽽⽾⽿⾀⾁⾂⾃⾄⾅⾆⾇⾈⾉⾊⾋⾌⾍⾎⾏⾐⾑⾒⾓⾔⾕⾖⾗⾘⾙⾚⾛⾜⾝⾞⾟⾠⾡⾢⾣⾤⾥⾦⾧⾨⾩⾪⾫⾬⾭⾮⾯⾰⾱⾲⾳⾴⾵⾶⾷⾸⾹⾺⾻⾼⾽⾾⾿⿀⿁⿂⿃⿄⿅⿆⿇⿈⿉⿊⿋⿌⿍⿎⿏⿐⿑⿒⿓⿔⿕
こうきじてんぶしゅ	一丨丶丿乙亅二亠人儿入八冂冖冫几凵刀力勹匕匚匸十卜卩厂厶又口囗土士夂夊夕大女子宀寸小尢尣尸屮巛工已巾干幺广廴廾弋弓彐彡彳心戈戸手支攴文斗斤方无日曰月木欠止歹殳毋比毛氏气水火爪父爻爿片牙牛犬玄玉瓜瓦甘生用田疋疒癶白皮皿⽬矛矢石示禸禾穴立竹米糸缶网羊羽老而耒耳聿肉臣自至𦥑艮艸艹艹艹虍襾覀訁豕豸𧾷车𨐋辵辶辶阝釆釒镸隶隹⻗靑靣韋韦韭𩙿飠𩚀𩚁髟鬥鬯鬲鹵卤麥黃黑黹齒龜龟龠
ぶしゅ				部首
部首	乀乁一丨丶丿乙乚亅二亠人亻𠆢儿入八冂冖冫几凵刀刂力勹匕匚匸十卜卩⺋厂厶又口囗土士夂夊夕大女子宀寸小⺌尢尣尸屮巛工已巾干幺广廴廾弋彐彑彡彳心忄㣺戈戸手扌支攴攵文斗斤方无旡日曰月木欠止歹殳毋毌比毛氏气水氵氺火灬爪爫父爻爿丬片牙牛牜犬犭玄玉瓜瓦甘生用甩电田疋𤴔疒癶白皮皿⽬矛矢石示罒礻禸禾穴立竹⺮米糸糹缶网罓𦉰㓁羊𦍌羽老耂而耒耳聿𦘒肀肉⺼臣自至𦥑艮艸艹艹艹虍衤襾覀訁豕豸𧾷车𨐋辵辶辶阝釆釒镸隶隹⻗靑靣韋韦韭𩙿飠𩚀𩚁髟鬥鬯鬲鹵卤麥黃黑黹齒龜龟龠
ナガレル			乁
フツ			乀
イチ			一
タテボウ			丨
テン			丶
ハライボウ		丿
オツ			乙
キノト			乙
ツリバリ			乚
ハネボウ			亅
ニ			二
ケイサンカンムリ		亠
ヒト			人
ニンベン			亻
ヒトヤネ			𠆢
ニンニョウ		儿
ニュウ			入
ハチ			八
ケイガマエ		冂
ワカンムリ		冖
ニスイ			冫
カゼガマエ		几
カンニョウ		凵
カタナ			刀
リットウ			刂
チカラ			力
ツツミガマエ		勹
サジノヒ			匕
ハコガマエ		匚
カクシガマエ		匸
ジュウ			十
ボクノト			卜
フシヅクリ		卩
マゲワリフ		⺋
ガンダレ			厂
ム			厶
マタ			又
クチヘン			口
クニガマエ		囗
ツチ			土
サムライ			士
フユガシラ		夂
スイニョウ		夊
ユウ			夕
ダイ			大
オンナ			女
コドモ			子
ウカンムリ		宀
スン			寸
ショウ			小
マゲアシ			尢
アシナエ			尣
カバネダレ		尸
メバエ			屮
ヤマ			山
マガリカワ		巛
カワ※部首		川
タクミ			工
オノレ			己
キンヘン			巾
カン			干
イトガシラ		幺
マダレ			广
エンニョウ		廴
コマヌキ			廾
シキガマエ		弋
ユミ			弓
イノコガシラ		彐
ケイガシラ		彑
サンヅクリ		彡
ギョウニンベン		彳
ココロ			心
リッシンベン		忄
シタゴコロ		㣺
ホコガマエ		戈
ト			戸
テ※部首			手
テヘン			扌
シニョウ			支
ボクニョウ		攴
ノブン			攵
ふみ			文
ト			斗
オノ※部首		斤
ホウ			方
ムニョウ			无
スデノツクリ		旡
ニチ			日
イワク			曰
カケル			欠
トメル			止
カバネヘン		歹
ホコヅクリ		殳
ナカレ			毋
カン※部首		毌
クラベル			比
ケ※部首			毛
ウジ			氏
キガマエ			气
ミズ			水
サンズイ			氵
シタミズ			氺
ヒ			火
レンガ			灬
チチ			父
コウ			爻
ショウ			爿
ショウヘン		丬
カタ※部首		片
キバ			牙
ウシ			牛
ウシヘン			牜
イヌ			犬
ケモノヘン		犭
ゲン			玄
タマ			玉
オウ			王
ショク			玊
ウリ			瓜
カワラ			瓦
アマイ			甘
イキル			生
モチイル			用
シュツ			甩
タ			田
コウ			甲
モウス			申
ユウ			由
ソウ			甴
デァン			电
ヒキ			疋
ヒキヘン			𤴔
ヤマイダレ		疒
シロ			白
カワ※部首		皮
サラ			皿
メ※部首			目
ヨコメ			罒
ヤ			矢
イシ			石
シメス			示
シメスヘン		礻
グウノアシ		禸
ノギ			禾
あな			穴
たつ			立
タケ			竹
タケカンムリ		⺮
こめ			米
イト			糸
イトヘン			糹
カン			缶
アミガシラ		网
ヨンガシラ		罓
モウガシラ		𦉰
マレガシラ		㓁
ヒツジ			羊
ヒツジガシラ		𦍌
ハネ			羽
ハネ※部首		羽
オイ			老
オイガシラ		耂
シコウシテ		而
ライスキ			耒
ミミ			耳
フデヅクリ		聿
ショウ			𦘒
ニィエ			肀
ニク			肉
ツキ			月
シン			臣
ミズカラ			自
イタル			至
シタ※部首		舌
マス			舛
フネ			舟
ウシトラ			艮
イロ			色
ソウコウ			艸
クサカンムリ		艹
クサカンムリA		艹
クサカンムリB		艹
トラガシラ		虍
ムシ			虫
チ			血
ギョウ			行
コロモ			衣
コロモヘン		衤
オオウ			襾
ニシガシラ		覀
ニシ			西
ミル			見
ツノ			角
ゴン			言
ゴンベン			訁
タニ			谷
マメ			豆
イノコ			豕
ムジナヘン		豸
カイ			貝
アカ			赤
ハシル			⾛
アシ			足
アシヘン			𧾷
ミ			身
クルマ			車
シャ			车
カライ			辛
シン			𨐋
シンニュウ		辵
シンニョウ		辶
ニテンシンニョウ		辶
オオザト			邑
コザト			阝
サケノトリ		酉
ノゴメ			釆
サト			里
カネ			金
カネヘン			釒
ナガイ			長
チョウ			镸
モン			門
ギフノフ			阜
レイヅクリ		隶
フルトリ			隹
アメ			雨
アメカンムリ		⻗
セイ			靑
アオ			青
アラズ			非
メン			面
メンブ			靣
カワ			革
ソムク			韋
ナメシガワ		韦
ニラ			韭
オト			音
オオガイ			頁
カゼ			風
トブ			飛
ショク			食
ショクヘン※康熙		𩙿
ショクヘン		飠
ショクヘン※ム		𩚀
ショクヘン※ヒ		𩚁
クビ			首
カオリ			香
ウマ			馬
ホネ			骨
タカイ			高
カミガシラ		髟
タタカイガマエ		鬥
ニオイザケ		鬯
レキ			鬲
オニ			鬼
サカナ			魚
トリ			鳥
ロ			鹵
ロ※部首			卤
シカ			鹿
バクニョウ		麥
ムギ			麦
アサ			麻
キ※康熙			黃
キ			黄
キビ			黍
クロ※康熙		黑
クロ			黒
ヌイトリ			黹
ベンアシ			黽
テイ			鼎
ツヅミ			鼓
ネズミ			鼠
ハナ※部首		鼻
セイ※部首		齊
セイ			斉
ハヘン			齒
ハ			歯
タツ			龍
リュウ			竜
カメ※康熙		龜
カメ			亀
カメ※部首		龟
ヤク			龠
きごう			記号
ドウチ			⇔
ホウゴウ			⇒
ロンリホウゴウ		⇒
ゴウドウ			≡
クォート			‘’
シングルクォート		‘’
ダブルクォート		“”
クォート２		“”
カギカッコ		「」
ニジュウカギカッコ	『』
カギカッコ２		『』
ナミカッコ		｛｝
マルカッコ		（）
ウムラウト		¨
トレマ			¨
アポストロフィー		＇
アキュート・アクセント	´
アキュートアクセント	´
グレイヴ・アクセント	｀
グレイヴアクセント	｀
イッテンリーダー		・
リーダ１			・
ニテンリーダー		‥
リーダ２			‥
サンテンリーダー		…
リーダ３			…
プライム			′
プライム１		′
ダブルプライム		′
プライム２		′
ド			°
オンド			°
セッシ			℃
セッシオンド		℃
カシ			℉
カシオンド		℉
オングストローム		Å
オスキゴウ		♂
メスキゴウ		♀
チルダ			～
ナミダッシュ		〜
セツキゴウ		§
ダンラクキゴウ		¶
コメジルシ		※
米印			※
タンケンフ		†
タンケンフ１		†
ニジュウタンケンフ	‡
タンケンフ２		‡
ゲタキゴウ		〓
ソウジキゴウ		∽
ヒレイキゴウ		∝
ムゲン			∞
ナゼナラバ		∵
スナワチ			∴
ユエニ			∴
サーカムフレックス	＾
ハイタテキロンリワ	⊕
セキブンキゴウ		∫
セキブン１		∫
ニジュウセキブンキゴウ	∬
セキブン２		∬
エンキゴウ		￥
ドルキゴウ		＄
セントキゴウ		￠
ポンドキゴウ		￡
リラキゴウ		￡
ユーロキゴウ		€
シメ			〆
シメキゴウ		〆
ドウジョウキゴウ		仝
ナンバーサイン		＃
シャープ			♯
フラット			♭
ナチュラル		♮
ノート			♪
オンプ			♪
オンプ４			♪
シブオンプ		♪
バーティカルバー		｜
ブロークンバー		￤
タス			＋
プラス			＋
ヒク			－
ハイフンマイナス		－
マイナス			－
カケル			×
アスタリスク		＊
ワル			÷
スラッシュ		／
バックスラッシュ		＼
イコール			＝
トウゴウ			＝
フトウゴウ		≠≦≧≒
トウゴウヒテイ		≠
キンジ			≒
ダイナリ			＞
ショウナリ		＜
ダイナリイコール		≧
ショウナリイコール	≦
ルート			√
コンゴウ			√
コンゴウキゴウ		√
オーバーライン		￣
ハイフン			‐
アンダースコア		＿
ブブンシュウゴウ		⊆⊇
シンブブンシュウゴウ	⊂⊃
ゲン			∈∋
セキシュウゴウ		∩
ワシュウゴウ		∪
ヒテイキゴウ		￢
ロンリセキ		∧
ロンリワ			∨
カクキゴウ		∠
チョッカクキゴウ		∟
スイチョクキゴウ		⊥
コ			⌒
コキゴウ			⌒
ゼンショウキゴウ		∀
ソンザイキゴウ		∃
デル			∂
パーシャルディー		∂
ラウンドディー		∂
ナブラ			∇
ナブラキゴウ		∇
ニジュウマル		◎
シロボシ			☆
クロボシ			★
シロマル			○
クロマル			●
シロヒシガタ		◇
クロヒシガタ		◆
シロシカク		□
クロシカク		■
シロサンカク		△
クロサンカク		▲
シロギャクサンカク	▽
クロギャクサンカク	▼
コピーライト		©
チョサクケン		©
トウロクショウヒョウ	®
ゲンバンケン		℗
トレードマーク		™
サービスマーク		℠
ヤクムショウヒョウ	℠
ヤジルシ			→
ウエヤジルシ		↑
シタヤジルシ		↓
ヒダリヤジルシ		→
ミギヤジルシ		←
ダクオン			゛
ハンダクオン		゜
ドクテン			、
クテン			。
ノノジテン		〃
ドウノジテン		々
ノマ			々
イチノジテン		ゝヽゞヾ
イチノジテンヒラガナセイオン	ゝ
イチノジテンカタカナセイオン	ヽ
イチノジテンヒラガナダクオン	ゞ
イチノジテンカタカナダクオン	ヾ
ユーロ			€
ドル			＄
エン			￥
セント			￠
ポンド			￡
リラ			￡
すうじ			数字
だいすう			大数
イチ			一
ニ			二
サン			三
ヨン			四
ゴ			五
ロク			六
ナナ			七
ハチ			八
キュウ			九
ジュウ			十
ヒャク			百
セン			千
マン			万
オク			億
チョウ※数字		兆
ケイ			京
ガイ			垓
ジョ			𥝱/秭
ジョウ			穣
コウ			溝
カン			澗
セイ			正
サイ			載
ゴク			極
ゴウガシャ		恒河沙
アソウギ			阿僧祇
ナユタ			那由他
フカシギ			不可思議
ムリョウタイスウ		無量大数
ラクシャ			洛叉
クテイ			倶胝
アユタ			阿庾多
ナユタ			那由他
ビンバラ			頻波羅
コンガラ			矜羯羅
アカラ			阿伽羅
サイショウ		最勝
マバラ			摩婆羅
アバラ			阿婆羅
タバラ			多婆羅
カイブン			界分
フマ			普摩
ネマ			禰摩
アバケン			阿婆鈐
ミカバ			弥伽婆
ビラカ			毘攞伽
ビカバ			毘伽婆
ソウガラマ		僧羯邏摩
ビサラ			毘薩羅
ビセンバ			毘贍婆
ビジョウガ		毘盛伽
ビスダ			毘素陀
ビバカ			毘婆訶
ビバテイ			毘薄底
ビキャタン		毘佉擔
ショウリョウ		称量
イチジ			一持
イロ※数			異路
テンドウ			顛倒
サンマヤ			三末耶
ビトラ			毘睹羅
ケイバラ			奚婆羅
シサツ			伺察
シュウコウ		周広
コウシュツ		高出
サイミョウ		最妙
ナイラバ			泥羅婆
カリバ			訶理婆
イチドウ			一動
カリボ			訶理蒲
カリサン			訶理三
ケイロカ			奚魯伽
タツラホダ		達攞歩陀
カロナ			訶魯那
マロダ			摩魯陀
ザンボダ			懺慕陀
エイラダ			瑿攞陀
マロマ			摩魯摩
チョウブク		調伏
リキョウマン		離憍慢
フドウ			不動
ゴクリョウ		極量
アマタラ			阿麼怛羅
ボマタラ			勃麼怛羅
ガマタラ			伽麼怛羅
ナマタラ			那麼怛羅
ケイマタラ		奚麼怛羅
ベイマタラ		鞞麼怛羅
ハラマタラ		鉢羅麼怛羅
シバマタラ		尸婆麼怛羅
エイラ			翳羅
ベイラ			薜羅
タイラ			諦羅
ゲラ			偈羅
ソホラ			窣歩羅
ナイラ			泥羅
ケイラ			計羅
サイラ			細羅
ヘイラ			睥羅
メイラ			謎羅
シャラダ			娑攞荼
メイロダ			謎魯陀
ケイロダ			契魯陀
マトラ			摩睹羅
シャモラ			娑母羅
アヤシャ			阿野娑
カマラ			迦麼羅
マカバ			摩伽婆
アタラ			阿怛羅
ケイロヤ			醯魯耶
ベイロバ			薜魯婆
カラハ			羯羅波
カババ			訶婆婆
ビバラ			毘婆羅
ナバラ			那婆羅
マララ			摩攞羅
シャバラ			娑婆羅
メイラフ			迷攞普
シャマラ			者麼羅
ダマラ			駄麼羅
ハラマダ			鉢攞麼陀
ビカマ			毘迦摩
ウハバタ			烏波跋多
エンゼツ			演説
ムジン			無尽
シュッショウ		出生
ムガ			無我
アバンタ			阿畔多
ショウレンゲ		青蓮華
ハドマ			鉢頭摩
ソウギ			僧祇
シュ			趣
シ※数			至
アソウギ			阿僧祇
アソウギテン		阿僧祇転
ムリョウ			無量
ムリョウテン		無量転
ムヘン			無辺
ムヘンテン		無辺転
ムトウ			無等
ムトウテン		無等転
フカスウ			不可数
フカスウテン		不可数転
フカショウ		不可称
フカショウテン		不可称転
フカシ			不可思
フカシテン		不可思転
フカリョウ		不可量
フカリョウテン		不可量転
フカセツ			不可説
フカセツテン		不可説転
フカセツフカセツ		不可説不可説
フカセツフカセツテン	不可説不可説転
しょうすう		小数
ブ※小数			分
リン※小数		厘
モウ※小数		毛
シ※小数			糸
コツ※小数		忽
ビ※小数			微
セン※小数		繊
シャ※小数		沙
ジン※小数		塵
アイ※小数		埃
ビョウ※小数		渺
バク※小数		漠
モコ			模糊
シュンジュン		逡巡
スユ			須臾
シュンソク		瞬息
ダンシ			弾指
セツナ			刹那
ロクトク			六徳
キョクウ			虚空
ショウジョウ		清浄
アラヤ			阿頼耶
アマラ			阿摩羅
ネハンジャクジョウ	涅槃寂静
たんい			単位
めーとる		米
マイクロメートル	粆
ミリメートル	粍
センチメートル	糎
デシメートル	粉
デカメートル	籵
ヘクトメートル	粨
キロメートル	粁
ぐらむ			瓦
ミリグラム		瓱
センチグラム	甅
デシグラム		瓰
デカグラム		瓧
ヘクトグラム	瓸
キログラム		瓩
トン			瓲
りっとる		立
ミリリットル	竓
センチリットル	竰
デシリットル	竕
デカリットル	竍
ヘクトリットル	竡
キロリットル	竏
まいる			哩
カイリ			浬


ようび			日月火水木金土
すらんぐ			スラング
サーバー			鯖
プロキシ			串
アカウント		垢
シリアル			尻
アマゾン			尼
パク・リー		朴李※Park Lee
アラン・スミシー		阿蘭住史※Alan Smithee
メアリー・スー		明鈴錫※Mary Sue
デウス・エクス・マキナ	江燻牧菜※Edison Machina
カミエクセル		ネ申Excel
ポケモン			赤緑青鼠金銀晶紅蒼火葉翠剛珠鉑心魂黒白黑㿟ＸＹωα日月
キュウダン		鷲鴎檻鷹鯉猫公兎虎竜燕星
ソードマスターヤマト	最極凶劣
モシモシテンノウ		忍竜武精死
ブンメイノレキシ		独米英仏伊日中韓
さんだんろんぽう		三段論法
ダイショウケツ		大小結
シュハリ			守破離
ジョハキュウ		序破急
キショウテンケツ		起承転結
キショウホジョケツ	起承鋪叙結
キショウホジョカケツ	起承鋪叙過結
キショウケツオワリ	起承結終
ショウテンテンテン	承転転転
テンテンテンテン		転転転転
キケツ			起結
ツリケツニゲ		釣結逃
キケツショウテン		起結承転
ケツショウテンテイ	結承転提
キショウホジョケツヤミ	起承転結闇
じゅうぎゅうず		十牛図
ジンギュウ		尋牛
ケンセキ			見跡
ケンギュウ		見牛
トクギュウ		得牛
ボクギュウ		牧牛
キギュウキカ		騎牛帰家
ボウギュウゾンニン	忘牛存人
ニンギュウグボウ		人牛倶忘
ヘンポンゲンゲン		返本還源
ニッテンスイシュ		入鄽垂手
よじじゅくご		四字熟語
シュンカシュウトウ	春夏秋冬
セイシュハクゲン		青朱白玄
インジュンコウショ	因循苟且
ギョモウコウリ		魚網鴻離
イチレンタクショウ	一蓮托生
セッサタクマ		切磋琢磨
ハッコウイチウ		八紘一宇
ケンケンヒキュウ		蹇々匪躬
ケンケンゴウゴウ		喧々囂々
カンカンガクガク		侃々諤々
チミモウリョウ		魑魅魍魎
ダンカクゾクフ		断鶴続鳧
エツフソイツ		越鳧楚乙
カクテイフショ		鶴汀鳧渚
メイキョウシスイ		明鏡止水
オンコチシン		温故知新
ジョウコシャソ		城狐社鼠
イチゴイチエ		一期一会
ガシンショウタン		臥薪嘗胆
シップウモクウ		櫛風沐雨
シキソクゼクウ		色即是空
エッチョウナンシ		越鳥南枝
オウリケイケイ		甕裡醯鶏
ラクヨウノシカ		洛陽紙価
カトラクショ		河図洛書
セキシダンケン		隻紙断絹
ヘンゲンセキゴ		片言隻語
ツツウラウラ		津々浦々
メイヨキソン		名誉毀損
ケンコンイッテキ		乾坤一擲
キュウソゴウビョウ	窮鼠噛猫
インギンブレイ		慇懃無礼
バジトウフウ		馬耳東風
ヒニクノタン		髀肉之嘆
フカロウズイ		浮花浪蕊
チィェンヂュンイーファー	千钧一发
チェンジュンイーファー	千钧一发
セッチュウショウハク	雪中松柏
イッセイフウビ		一世風靡
ジカドウチャク		自家撞着
キコクシュウシュウ	鬼哭啾啾
シュレンテクダ		手練手管
センジュウカイシ	先従隗始
チョウリョウバッコ		跳梁跋扈


