[L:Tsv|
code	UTF-8
enter	LF
tab	8
program	LTsv_kbd.py
LTsvver	20160718M003911
modify	20160827S072419
|L:Tsv]

[kanglyph|
dicname		kanchar.tsv
mapname		kanmap.tsv
pickleGTKname	kanpickleGTK.bin
pickleTkintername	kanpickleTkinter.bin
irohatype		ぬ	ふ	あ	う	え	お	や	ゆ	よ	わ	ほ	へ	た	て	い	す	か	ん	な	に	ら	せ	゛	゜	ち	と	し	は	き	く	ま	の	り	れ	け	む	つ	さ	そ	ひ	こ	み	も	ね	る	め	ろ	￥
irohatypeN	ぬ	ふ	あ	う	え	お	や	ゆ	よ	わ	ほ	へ	た	て	い	す	か	ん	な	に	ら	せ	＠	ぷ	ち	と	し	は	き	く	ま	の	り	れ	け	む	つ	さ	そ	ひ	こ	み	も	ね	る	め	ろ	￥
irohatypeX	ヌ	フ	ア	ウ	エ	オ	ヤ	ユ	ヨ	ワ	ホ	ヘ	タ	テ	イ	ス	カ	ン	ナ	ニ	ラ	セ	｀	プ	チ	ト	シ	ハ	キ	ク	マ	ノ	リ	レ	ケ	ム	ツ	サ	ソ	ヒ	コ	ミ	モ	ネ	ル	メ	ロ	｜
alphatype		α	β	γ	δ	ε	ζ	η	θ	ι	κ	λ	μ	ν	ξ	ο	π	ρ	σ	τ	υ	φ	χ	ψ	ω	○	△	□
alphatypeN	α	β	γ	δ	ε	ζ	η	θ	ι	κ	λ	μ	ν	ξ	ο	π	ρ	σ	τ	υ	φ	χ	ψ	ω	○	△	□
alphatypeX	Α	Β	Γ	Δ	Ε	Ζ	Η	Θ	Ι	Κ	Λ	Μ	Ν	Ξ	Ο	Π	Ρ	Σ	Τ	Υ	Φ	Χ	Ψ	Ω	●	▲	■
dictype		英	名	音	訓	送	異	俗	熙	簡	繁	越	地	顔	鍵	代	逆	非	難	活	漫	幅
glyphtype		活	漫
choice			名	音	訓	送	異	俗	簡	繁	越	地	逆	非	英	顔	ε	ρ	τ	υ	θ	ι	ο	π	＠	ぷ	α	σ	δ	φ	γ	η	ξ	κ	λ	代	鍵	ぬ	ζ	χ	ψ	ω	β	ν	μ	熙	○	△	□	￥	σ
choiceN		名	音	訓	送	異	俗	簡	繁	越	地	逆	非	英	顔	ε	ρ	τ	υ	θ	ι	ο	π	＠	ぷ	α	σ	δ	φ	γ	η	ξ	κ	λ	代	鍵	ぬ	ζ	χ	ψ	ω	β	ν	μ	熙	○	△	□	￥	σ
choiceX		名	音	訓	送	異	俗	簡	繁	越	地	逆	非	英	顔	Ε	Ρ	Τ	Υ	Θ	Ι	Ο	Π	｀	プ	Α	Σ	Δ	Φ	Γ	Η	Ξ	Κ	Λ	代	鍵	ぬ	Ζ	Χ	Ψ	Ω	Β	Ν	Μ	熙	●	▲	■	￥	Σ
kbdTAG		kanglyphkbd
fontcolor		black
bgcolor		#FFCBFF
kbddefsize	1
last_alpha	￥
last_dic	英
|kanglyph]

[reversi|
entry	ＴＳ０
|reversi]
